宫倾城=Cung Khuynh Thành
七绝堂=Thất Tuyệt Đường
柯镇=Kha Trấn
大光明拳=Đại Quang Minh Quyền
甘清池=Cam Thanh Trì
钱帮=Tiền Bang
女剑=Nữ Kiếm
山剑=Sơn Kiếm
银蛟剑=Ngân Giao Kiếm
理国=Lý Quốc
也知=Dã Tri
山剑法=Sơn Kiếm Pháp
铁开山=Thiết Khai Sơn
便知=Tiện Tri
阳城=Dương Thành
神锋楼=Thần Phong Lâu
风细雨楼=Phong Tế Vũ Lâu
就知=Tựu Tri
忘经=Vong Kinh
明神=Minh Thần
苏星=Tô Tinh
金刀天王=Kim Đao Thiên Vương
都知=Đô Tri
罗汉伏魔神=La Hán Phục Ma Thần
天阴派=Thiên Âm Phái
念禅院=Niệm Thiền Viện
龟兹王=Quy Tư Vương
汉拳=Hán Quyền
理城=Lý Thành
龙寺=Long Tự
胡铁=Hồ Thiết
宫倾城=Cung Khuynh Thành
丘伊人=Khâu Y Nhân
左丘伊=Tả Khâu Y
柳若=Liễu Nhược
黎世=Lê Thế
朱七=Chu Thất
都有=Đô Hữu
屠千=Đồ Thiên
明此=Minh Thử
金世=Kim Thế
铁翅天=Thiết Sí Thiên
贺人=Hạ Nhân
黎彩=Lê Thải
厉盼=Lệ Phán
林铃=Lâm Linh
张顶=Trương Đỉnh
明脸上=Minh Kiểm Thượng
薛笑=Tiết Tiếu
张青松=Trương Thanh Tùng
秋素=Thu Tố
师道=Sư Đạo
铁佛尊=Thiết Phật Tôn
侯营=Hầu Doanh
方灵月=Phương Linh Nguyệt
风翎=Phong Linh
商清=Thương Thanh
大乾世=Đại Càn Thế
水母阴=Thủy Mẫu Âm
傅采=Phó Thải
吴陆=Ngô Lục
子都=Tử Đô
容博=Dung Bác
白万=Bạch Vạn
陆奇=Lục Kỳ
阎本=Diêm Bản
金无=Kim Vô
杨允=Dương Doãn
巴天=Ba Thiên
姬晓=Cơ Hiểu
童月=Đồng Nguyệt
玉彤=Ngọc Đồng
阎立=Diêm Lập
万花=Vạn Hoa
左子=Tả Tử
花夫=Hoa Phu
敖无=Ngao Vô
洪烈=Hồng Liệt
颜洪=Nhan Hồng
慕容秀=Mộ Dung Tú
明脸色=Minh Kiểm Sắc
华赫=Hoa Hách
大先=Đại Tiên
安小=An Tiểu
赫艮=Hách Cấn
连退=Liên Thối
圆月弯=Viên Nguyệt Loan
林中人=Lâm Trung Nhân
王天寿=Vương Thiên Thọ
关中=Quan Trung
子也=Tử Dã
柯镇=Kha Trấn
大光明拳=Đại Quang Minh Quyền
甘清池=Cam Thanh Trì
黑蛟军=Hắc Giao Quân
封羽=Phong Vũ
明长=Minh Trường
钱帮=Tiền Bang
原著中=Nguyên Trứ Trung
方证=Phương Chứng
王小=Vương Tiểu
姬冰雁=Cơ Băng Nhạn
山剑=Sơn Kiếm
崔凌=Thôi Lăng
沈落=Thẩm Lạc
王金=Vương Kim
康大先生=Khang Đại Tiên Sinh
乔北溟=Kiều Bắc Minh
石中坚=Thạch Trung Kiên
银蛟剑=Ngân Giao Kiếm
林高=Lâm Cao
王夫=Vương Phu
石破=Thạch Phá
经有=Kinh Hữu
西门牧野=Tây Môn Mục Dã
万劫刀=Vạn Kiếp Đao
宋某人=Tống Mỗ Nhân
苏无二=Tô Vô Nhị
刘舟=Lưu Chu
子便=Tử Tiện
明更=Minh Canh
段延=Đoạn Diên
穆人=Mục Nhân
谢管=Tạ Quản
韦小=Vi Tiểu
鲁大=Lỗ Đại
哈哈大=Cáp Cáp Đại
哈大笑=Cáp Đại Tiếu
家兄弟=Gia Huynh Đệ
桑木姥=Tang Mộc Mụ
谢道灵=Tạ Đạo Linh
仲君=Trọng Quân
后便=Hậu Tiện
左冷=Tả Lãnh
德言=Đức Ngôn
文伤=Văn Thương
方大=Phương Đại
罗尊=La Tôn
谭公=Đàm Công
赵德=Triệu Đức
都无=Đô Vô
大乾天=Đại Càn Thiên
子当中=Tử Đương Trung
孙仲君=Tôn Trọng Quân
山剑法=Sơn Kiếm Pháp
左公龙=Tả Công Long
巫行空=Vu Hành Không
容复=Dung Phục
时也=Thì Dã
明如=Minh Như
步而=Bộ Nhi
焦木=Tiêu Mộc
白自=Bạch Tự
连方=Liên Phương
康州武林=Khang Châu Vũ Lâm
玉培新=Ngọc Bồi Tân
铁开山=Thiết Khai Sơn
祖窍=Tổ Khiếu
阳城=Dương Thành
黑龙老大=Hắc Long Lão Đại
万大军=Vạn Đại Quân
上官金=Thượng Quan Kim
周天公=Chu Thiên Công
大罗尊=Đại La Tôn
官金虹=Quan Kim Hồng
李红袖=Lý Hồng Tụ
李飞刀=Lý Phi Đao
武功也=Vũ Công Dã
云道=Vân Đạo
向四=Hướng Tứ
家大=Gia Đại
杨莲=Dương Liên
林大=Lâm Đại
梅超=Mai Siêu
王乔=Vương Kiều
荣凤=Vinh Phượng
高智=Cao Trí
金风细雨=Kim Phong Tế Vũ
风细雨楼=Phong Tế Vũ Lâu
鱼龙道人=Ngư Long Đạo Nhân
江流风=Giang Lưu Phong
苏蓉蓉=Tô Dung Dung
都有些=Đô Hữu Ta
高智升=Cao Trí Thăng
大咧=Đại Liệt
子里=Tử Lý
容凤=Dung Phượng
尤楚=Vưu Sở
明神=Minh Thần
苏星=Tô Tinh
贺师=Hạ Sư
大欢喜女菩萨=Đại Hoan Hỉ Nữ Bồ Tát
万古邪帝=Vạn Cổ Tà Đế
金刀天王=Kim Đao Thiên Vương
大大咧=Đại Đại Liệt
宇文化=Vũ Văn Hóa
宋余成=Tống Dư Thành
文化及=Văn Hóa Cập
明摸摸=Minh Mạc Mạc
林高手=Lâm Cao Thủ
武林大=Vũ Lâm Đại
从方=Tòng Phương
卫冼=Vệ Tiển
吕雷=Lữ Lôi
商震=Thương Chấn
官飞=Quan Phi
时还=Thì Hoàn
杜伏=Đỗ Phục
能有=Năng Hữu
薛统=Tiết Thống
都知=Đô Tri
任凭什=Nhậm Bằng Thập
双手合=Song Thủ Hợp
后天绝=Hậu Thiên Tuyệt
杨义贞=Dương Nghĩa Trinh
武侠世=Vũ Hiệp Thế
武功虽=Vũ Công Tuy
武功高=Vũ Công Cao
武林高=Vũ Lâm Cao
玉容凤=Ngọc Dung Phượng
罗汉伏=La Hán Phục
金毛狻=Kim Mao Toan
金眼彪=Kim Nhãn Bưu
黑龙组=Hắc Long Tổ
唐元=Đường Nguyên
大摇=Đại Dao
所未=Sở Vị
明左=Minh Tả
连家=Liên Gia
都说=Đô Thuyết
鹿鼎=Lộc Đỉnh
大光明拳印=Đại Quang Minh Quyền Ấn
罗汉伏魔神=La Hán Phục Ma Thần
后天绝顶=Hậu Thiên Tuyệt Đỉnh
大乾天子=Đại Càn Thiên Tử
大江盟主=Đại Giang Minh Chủ
大摇大=Đại Dao Đại
大理段=Đại Lý Đoạn
宋甜儿=Tống Điềm Nhi
崔希敏=Thôi Hi Mẫn
左归辛=Tả Quy Tân
念禅院=Niệm Thiền Viện
林大会=Lâm Đại Hội
铁燕夫=Thiết Yến Phu
静念禅=Tĩnh Niệm Thiền
高手都=Cao Thủ Đô
东淫=Đông Dâm
乐春=Nhạc Xuân
冯蘅=Phùng Hành
史小=Sử Tiểu
后就=Hậu Tựu
子脸=Tử Kiểm
尚秀=Thượng Tú
师都=Sư Đô
方先=Phương Tiên
明无=Minh Vô
明转=Minh Chuyển
杨震=Dương Chấn
玉弓=Ngọc Cung
王成=Vương Thành
铁中=Thiết Trung
阴真=Âm Chân
青人=Thanh Nhân
风双=Phong Song
龙寺=Long Tự
