10000000000000000000000000000000000000000000=10000000000000000000000000000000000000000000
2EGY-57XC-9Q61-7SKR-81MT-3DPW-76AP-5E2K-99VS=2EGY-57XC-9Q61-7SKR-81MT-3DPW-76AP-5E2K-99VS
扶云, 太微, 神光, 天音, 青冥, 伏魔, 潇湘=Phù Vân, Thái Vi, Thần Quang, Thiên Âm, Thanh Minh, Phục Ma, Tiêu Tương
天, 阿修罗, 人间, 兽王, 恶鬼, 黄泉=Thiên, A Tu La, Nhân Gian, Thú Vương, Ác Quỷ, Hoàng Tuyền
G- 五百一十一 - 三千一百四十四 - 六=G-511-3144-6
734876X34235SG12P=734876X34235SG12P
Tauren Chieftain=Tauren Chieftain
诸天 10 地万圣至尊雄霸天下诀=Chư Thiên Thập Địa Vạn Thánh Chí Tôn Hùng Bá Thiên Hạ Quyết
谢. . . 道. . . 灵=Tạ. . . Đạo. . . Linh
沙. . . 沙. . . 沙=Sa. . . Sa. . . Sa
D76892V19652537=D76892V19652537
南旧巷第五街区251号二楼三室=phòng 3, tầng 2, số 251, khu phố 5, hẻm Nam Cựu
十二刻度正反世界无限淘汰之握=Mười Hai Khắc Độ Chính Phản Thế Giới Vô Hạn Đào Thải Ác
F-799-5911-3 区=Khu F-799-5911-3
风, 雷, 光, 暗, 音=Phong, Lôi, Quang, Ám, Âm
末. . . 日. . .=Tận. . . Thế. . .
诸天十地万圣至尊雄霸天下诀=Chư Thiên Thập Địa Vạn Thánh Chí Tôn Hùng Bá Thiên Hạ Quyết
利, 宝, 灵, 法, 道=Lợi, Bảo, Linh, Pháp, Đạo
黑夜天穹之三缺一特急召唤法=Hắc Dạ Thiên Khung Tam Khuyết Đặc Cấp Nhất Triệu Hoán Pháp
冲, 崩, 甩, 碾, 捶=Xung, Băng, Sủy, Niễn, Chùy
野... 兽之... 神=Dã... Thú Chi... Thần
顾 —— 青 —— 山=Cố —— Thanh —— Sơn
周=tuần
简=Jane
一环=Nhất Hoàn
七环=Thất Hoàn
万象=Vạn Tượng
三世=III
三月=Tam Nguyệt
三环=Tam Hoàn
上尉=Thượng Úy
下坠=hạ xuống
不死=Bất Tử
不老=Bất Lão
中尉=Trung Úy
中环=Trung Hoàn
丽塔=Rita
丽莎=Lisa
丽雅=Liya
乔亚=Joya
乔伊=Joy
乔娅=Kiều Á
乔尔=Joel
乔尹=Kiều Doãn
乔戈=Kiều Qua
九环=Cửu Hoàn
二环=Nhị Hoàn
五环=Ngũ Hoàn
亚鲁=Yaru
亡灵=Vong Linh
亨利=Henry
亵渎=Khinh Nhờn
以太=Aether
仪式=Nghi Thức
伊凡=Ivan
伊坲=Yifa
伊戈=Ego
伍德=Wood
传承=Truyền Thừa
伦琴=Röntgen
伯爵=Bá Tước
低环=Đê Hoàn
何芈=Hà Mị
余光=Dư Quang
余辉=Dư Huy
作家=Tác Gia
佩姬=Paige
佩里=Perry
侦探=Thám Tử
侯爵=Hầu Tước
便士=Penny
信仰=Tín Ngưỡng
修顿=Shorten
元素=Nguyên Tố
先令=Shilling
克朗=Crans
八环=Bát Hoàn
六环=Lục Hoàn
兰奇=Ranch
内姆=Nem
内瑟=Neser
冥想=Minh Tưởng
冥月=Minh Nguyệt
冯思=Phùng Tư
凌晨=rạng sáng
凯德=Cade
函授=Hàm Thụ
创始=Sáng Lập
创造=Sáng Tạo
初火=Sơ Hỏa
十三=Thập Tam
十环=Thập Hoàn
十阶=Thập Giai
升华=Thăng Hoa
半神=Bán Thần
华生=Waston
协会=Hiệp Hội
博德=Bode
卡佳=Katya
卡拉=Kara
卢赫=Lư Hách
原初=Nguyên Sơ
古神=Cổ Thần
古罗=Gurro
古道=Cổ đạo
只是=chỉ là
史东=Stone
史诗=Sử Thi
吉娜=Gina
启迪=Gợi mở
吸血=Vampire
周一=thứ hai
周三=thứ tư
周二=thứ ba
周六=thứ bảy
周四=thứ năm
周围=chung quanh
周日=chủ nhật
命环=Mệnh Hoàn
咒文=Chú Văn
咒术=Chú Thuật
哈克=Hack
哈利=Harry
哈德=Hard
哈肯=Hacken
哲学=Triết Học
唤神=Hoán Thần
善神=Thiện Thần
嘉琳=Gia Lâm
器物=Khí Vật
四环=Tứ Hoàn
回响=Hồi Hưởng
国王=Quốc Vương
圣光=Thánh Quang
圣徽=Thánh Huy
圣歌=Anthem
圣水=Thánh Thủy
圣者=Thánh Giả
圣铃=Thánh Linh
地区=Khu Vực
地带=Khu Vực
基阵=Cơ Trận
塔薇=Tháp Vi
增殖=Tăng Thực
夏德=Shade
夜泉=Dạ Tuyền
夜空=Dạ Không
大地=Đại Địa
大宙=Đại Trụ
大罪=Đại Tội
太阳=Thái Dương
奇术=Kỳ Thuật
奥秘=Huyền Bí
姚惠=Diêu Huệ
姬丝=Jiss
威纶=Willo
威雅=Via
威顿=Witton
婚礼=Hôn Lễ
子爵=Tử Tước
孙胜=Tôn Thắng
学会=Học Hội
学派=Học Phái
学院=Học Viện
安吉=Angie
安娜=Anna
安茹=An Như
安魂=An Hồn
密人=Mật Nhân
密仪=mật nghi
尼特=Nid
山铜=Orichalcum
崔璐=Thôi Lộ
巫师=Vu Sư
巫术=Vu Thuật
巴顿=Patton
市制=Thị Chế
布克=Booker
希维=Hivey
希顿=Heaton
帕沃=Pavo
帝国=Đế Quốc
库珀=Cooper
庞恩=Bàng Ân
庞顿=Bàng Đốn
康娜=Kanna
异常=Dị Thường
异界=Dị Giới
异种=Dị Chủng
张莎=Trương Toa
张诗=Trương Thi
弥尔=Mill
彼得=Peter
往世=Vãng Thế
律令=Luật Lệnh
德昂=Deang
心灵=Tâm Linh
念写=Niệm Tả
怀特=White
怨灵=Oán Linh
总会=tổng hội
恩维=Envi
恶灵=Ác Linh
懒惰=Lười Biếng
戴斯=Dice
打兰=Talan
托马=Thomas
拉康=Lacan
拉文=Lavin
拉特=Larter
拜伦=Byron
拜德=Bader
提斯=Tis
提昂=Tion
撼地=Hám Địa
教会=Giáo Hội
教团=Giáo Đoàn
教堂=Giáo Đường
教士=Giáo Sĩ
教宗=Giáo Hoàng
文学=Văn Học
文明=Văn Minh
斯派=Spicy
新月=Tân Nguyệt
无常=Vô Thường
日安=Một Ngày Tốt Lành
旧日=Cựu Nhật
旧神=Cựu Thần
时空=Thời Không
旺达=Wanda
昂斯=Anse
明牌=Minh Bài
星星=Ngôi Sao
星空=Tinh Không
普斯=Pussy
智者=Trí Giả
暴怒=Bạo Nộ
暴食=Bạo Thực
曼宁=Manning
月光=Nguyệt Quang
月溪=Nguyệt Khê
朗道=Landau
木偶=Mộc Ngẫu
本恩=Benn
杜威=Dewey
杜尔=Toole
杜恩=Doon
杜茵=Đỗ Nhân
杰克=Jack
杰琳=Jaylin
林奇=Lâm Kỳ
柳固=Liễu Cố
树父=Thụ Phụ
核心=Hạch Tâm
格林=Green
桑德=Sander
桑美=Sammy
梁宇=Lương Vũ
梁家=Lương gia
梅森=Mason
梦境=Mộng Cảnh
梦笔=Mộng Bút
欧尔=Algiz
欧得=Oud
欧肯=Oaken
歌德=Goethe
正神=Chính Thần
残响=Tàn Hưởng
毁灭=Hủy Diệt
比克=Bick
比尔=Bill
水银=Thủy Ngân
永夜=Vĩnh Dạ
汉克=Hank
汉密=Hammy
汉默=Hammer
沃克=Walker
沧桑=tang thương
河谷=Hà Cốc
法典=Pháp Điển
法庭=Pháp Đình
法默=Farmer
洛茜=Rosie
海伦=Helen
海妖=Hải Yêu
海崖=Hải Nhai
海盗=Hải Tặc
海菈=Haela
混沌=Hỗn Độn
溺亡=Nịch Vong
潘塔=Phan Tháp
灵体=Linh Thể
灵修=Linh Tu
灵光=Linh Quang
灵性=Linh Tính
炼金=Luyện Kim
炽阳=Sí Dương
烟草=yên thảo
爱神=Thần Tình Yêu
爵士=Tước Sĩ
狭间=Hiệp Gian
猩红=Tinh Hồng
献祭=Hiến Tế
王后=Vương Hậu
王国=Vương Quốc
王子=Vương Tử
王室=Vương Thất
王牌=Vương Bài
王长=Vương Trường
玛丽=Mary
玛姬=Maggie
玛娜=Mana
环数=Hoàn Số
珍妮=Jenny
琼斯=Jones
生死=Sinh Tử
男爵=Nam Tước
番尼=Fanny
疫医=Dịch Y
痴愚=Si Ngu
白银=Bạch Ngân
皇帝=Hoàng Đế
眷属=Quyến Chúc
石廊=Thạch Lang
石矛=Thạch Mâu
石雕=Thạch Điêu
神学=Thần Học
神性=Thần Tính
神明=Thần Minh
神术=Thần Thuật
神殿=Thần Điện
神父=Cha Xứ
神祇=Thần Linh
神秘=Thần Bí
神职=Thần Chức
神降=Thần Giáng
福伦=Foran
福吉=Fudge
秘银=Mithril
穆迪=Moody
穿梭=Xuyên Toa
立姆=Lim
童真=đồng chân
童话=Truyện Cổ Tích
符文=Phù Văn
简单=đơn giản
简朴=đơn giản
简直=quả thực
米堡=Mid Pháo Đài
米娅=Mia
米德=Meade
精灵=Elf
索伦=Sauron
索斯=sos
繁花=phồn hoa
红水=Hồng Thủy
红龙=Hồng Long
约翰=John
纽曼=Newman
终末=Chung Mạt
终结=Chung Kết
结晶=Kết Tinh
罗兰=Roland
罗德=Rhodes
罗根=Logan
罗盘=La Bàn
罗素=La Tố
耶伦=Yellen
耶娃=Eve
胡椒=Hồ Tiêu
至高=Chí Cao
艾尔=El
艾莎=Elsa
芬尼=Finney
芬迪=Fendi
苏伦=Suellen
苏菲=Sophie
英尺=Feet
英里=Miles
茉莉=Jasmine
草药=Thảo Dược
药丸=Dược Hoàn
药品=Dược Phẩm
莉娅=Leah
莎拉=Sarah
莫克=Mạc Khắc
莫德=Mạc Đức
莫泊=Mạc Bạc
莱恩=Ryan
莱昂=Leon
莱茵=Rhine
菲欧=Feo
菲雅=Feiya
萨利=Sally
萨菈=Sara
萨里=Surrey
蒂法=Tifa
蓓姬=Becky
蕾西=Lacey
薇拉=Vera
蠕虫=Nhuyễn Trùng
血之=Huyết Chi
血宴=Huyết Yến
血族=Huyết Tộc
血湖=Huyết Hồ
血灵=Huyết Linh
血统=Huyết Thống
血脉=Huyết Mạch
血色=Huyết Sắc
血衣=Huyết Y
血酒=Huyết Tửu
血酿=Huyết Nhưỡng
血钱=Huyết Tiền
血雾=Huyết Vụ
裂痕=Liệt Ngân
裘德=Jude
要素=Yếu Tố
诗人=Poet
诗章=Bài Thơ
诺克=Knock
诺尔=Noel
诺玛=Norma
贝纳=Bena
贤者=Hiền Giả
账务=trướng vụ
费勒=Feller
费林=Flynn
费莲=Phí Liên
赞歌=Tán Ca
赤金=Xích Kim
超凡=Siêu Phàm
路德=Luther
路标=Lộ Tiêu
轮环=Luân Hoàn
达克=Duck
迪卡=Dika
迪蒙=Dimon
迭加=điệp gia
迷宫=Mê Cung
迷锁=Mê Tỏa
通灵=Thông Linh
遗物=Di Vật
遮普=Jab
邓恩=Dunn
邦迪=Bondi
邪灵=Tà Linh
邪物=Tà Vật
邪神=Tà Thần
里克=Rick
里昂=Lyon
里莫=Rimmer
重剑=Trọng Kiếm
重启=Khởi Động Lại
金斯=Kim Tư
金星=Kim Tinh
金色=Kim Sắc
金蕊=Kim Nhị
金镑=Kim Bảng
铁锈=Rust
铭刻=Minh Khắc
银色=Ngân Sắc
长廊=Hành Lang
阿德=Ade
阿雅=Aya
附身=Phụ Thân
陆军=Lục Quân
雅克=Jacques
雪莉=Shirley
雷光=Lôi Quang
雷枪=Lôi Thương
雷霆=Lôi Đình
霍格=Hogg
霍桑=Hawthorne
霍莉=Holly
非凡=phi phàm
预言=Dự Ngôn
领域=Lĩnh Vực
马林=Marin
驱魔=Khu Ma
高德=Gaode
高环=Cao Hoàn
魔男=Ma Nam
魔药=Ma Dược
鱼脸=Ngư Kiểm
鲁夫=Ruff
鲁格=Luger
鲁特=Root
鸣钟=Minh Chung
黄月=Hoàng Nguyệt
黎固=Lê Cố
黑书=Hắc Thư
黑角=Noire
黑铁=Hắc Thiết
齐娜=Zina
龙毒=Long Độc
龙鳞=Long Lân
三只猫=Three Cats
不可知=Bất Khả Tri
不死鸟=Bất Tử Điểu
不老药=Bất Lão Dược
不适合=không thích hợp
世界树=Thế Giới Thụ
东大陆=Đông Đại Lục
中大陆=Trung Đại Lục
乔戈里=Chogori
书写者=Viết Giả
亚空间=Á Không Gian
亡灵马=Vong Linh Mã
亨利希=Heinrich
亨廷顿=Huntington
亨德尔=Handel
人之脓=Người Chi Mủ
仪式基=Nghi Thức Cơ
仪式学=Nghi Thức Học
伊克姆=Ikem
伊拉尔=Ilar
伊露娜=Ilouna
休格曼=Sugarman
伟大者=Vĩ Đại Giả
传承了=Truyền Thừa
伦德尔=Lendl
伦道夫=Randolph
伦道尔=Randall
但尼特=Danite
修斯卡=Hugheska
倒吊人=Người Treo Ngược
光亮术=thuật ánh sáng
光球术=Quang Cầu Thuật
克拉娜=Clara
克洛伊=Chloe
克洛尹=Chloe
克莱因=Klein
克里青=Kriching
克鲁姆=Krum
六环的=Lục Hoàn
兰德尔=Randall
内姆吧=Nem bar
冬神的=Đông Thần
冯塞卡=Fonseca
冷水港=Cold Spring Harbor
凯泽姆=Kesem
创始人=Người Sáng Lập
创造者=Sáng Tạo Giả
初火的=Sơ Hỏa
利斯特=Lister
剧作家=Kịch Tác Gia
副教授=Phó Giáo Thụ
加拉尔=Gallard
加罗夫=Garoff
加西亚=Garcia
劳伦斯=Lawrence
劳恩斯=Lawnes
劳瑞尔=Laurel
劳艾尔=Lauel
勒梅尔=Flamel
勒诺曼=Lenormand
十一环=Thập Nhất Hoàn
十一阶=Thập Nhất Giai
十三环=Thập Tam Hoàn
十三阶=Thập Tam Giai
十二环=Thập Nhị Hoàn
十二阶=Thập Nhị Giai
南大陆=Nam Đại Lục
博尔博=Borbo
占卜家=Chiêm Bặc Gia
占卜师=Chiêm Bặc Sư
占卜者=Chiêm Bặc Giả
卡尔顿=Carlton
卡拉德=Kalad
卡拉斯=Callas
卡里斯=Caris
卢卡斯=Lucas
卢旺达=Rwanda
卢比奥=Rubio
卢赫湖=Lư Hách Hồ
即所谓=tức cái gọi là
历史学=Lịch Sử Học
双子神=Song Tử Thần
变形术=Biến Hình Thuật
古代文=Cổ Đại Văn
古代语=Cổ Đại Ngữ
古德曼=Cổ Đức Mạn
古德温=Goodwin
古老者=Cổ Lão Giả
古鲁斯=Gurus
史密斯=Smith
史莱奇=Sledge
史迪奇=Stitch
史迪威=Stilwell
吉姆斯=Jims
吉尔斯=Gilles
同心剑=Đồng Tâm Kiếm
吸血种=Hấp Huyết Chủng
吸血鬼=Hấp Huyết Quỷ
告死者=Cáo Tử Giả
周围的=chu vi
咒术石=Chú Thuật Thạch
哈姆斯=Harms
哥伦巴=Columba
唤神者=Gọi Thần Giả
唤蝶笛=Hoán Điệp Sáo
善良之=Thiện Lương Chi
嘉琳娜=Carina
噬龙魔=Phệ Long Ma
图书馆=Thư Viện
圣佩里=Thánh Perry
圣卡拉=Santa Carla
圣德兰=Saint Teresa
圣约克=St York
圣罗兰=Saint Roland
地点型=Địa Điểm Hình
地质学=Địa Chất Học
地震术=Địa Chấn Thuật
坎贝拉=Canberra
埃里克=Eric
基路伯=Cherubim
塔兰康=Talancon
塔薇尔=Tavel
塞维尔=Savior
塞缪尔=Samuel
塞西亚=Scythia
塞里奇=Seric
复仇者=Phục Cừu Giả
复生术=Phục Sinh Thuật
夏先生=Hạ tiên sinh
夏卡迪=Shakadi
夏夜集=Hạ Dạ Tập
夏帕尔=Chapar
夏德利=Hạ Đức Lợi
夏德才=Hạ Đức Tài
夏德拉=Shade kéo
夏德望=Hạ Đức Vọng
夏德语=Hạ Đức Ngữ
夏爵士=Hạ Tước Sĩ
夏维科=Xia Vico
外乡人=Người Xứ Khác
多洛茜=Dorothy
多萝茜=Dorothy
夜之刃=Dạ Chi Nhận
夜之神=Dạ Chi Thần
大作家=Đại Tác Gia
大侦探=Đại Thám Tử
大教区=Đại Giáo Khu
大教堂=Đại Giáo Đường
大沼泽=Đầm Lầy Lớn
大王子=Đại Vương Tử
大精灵=Đại Tinh Linh
大贤者=Đại Hiền Giả
大雪球=Đại Tuyết Cầu
大预言=Đại Dự Ngôn
大魔女=Đại Ma Nữ
天使化=Thiên Sứ Hóa
天使级=Thiên Sứ Cấp
天堂岛=Thiên Đường Đảo
天文学=Thiên Văn Học
天赋者=Thiên Phú Giả
太阳拳=Thái Dương Quyền
太阳神=Thái Dương Thần
太阳纹=Thái Dương Văn
奥丽芙=Olive
奥古斯=August
奥尔朗=Orlan
奥格莱=Ogle
奥森弗=Oxenford
奥福斯=Ophus
奥赛尔=Auxerre
奥黛丽=Audrey
女作家=Nữ Tác Gia
女公爵=Nữ Công Tước
女术士=Nữ Thuật Sĩ
姚惠卿=Diêu Huệ Khanh
娜塔莉=Natalie
学院派=Học Viện Phái
宇天功=Vũ Thiên Công
守塔人=Thủ Tháp Nhân
守夜人=Người Gác Đêm
守密人=Keeper
守密者=Thủ Mật Giả
守秘者=Thủ Bí Giả
安东尼=Anthony
安吉拉=Angela
安娜特=Anat
安洛斯=An Lạc Tư
安特鲁=Antru
宝箱怪=Bảo Rương Quái
审判者=Thẩm Phán Giả
家族的=Gia Tộc
寒冰咒=Hàn Băng Chú
封印物=Phong Ấn Vật
小女士=Tiểu Nữ Sĩ
小米亚=tiểu Mia
小米娅=Mia
小约翰=Tiểu John
小说家=Tiểu Thuyết Gia
尤迪特=Vưu Địch Đặc
尹露娜=Iruna
尼德罗=Nidro
山之城=Sơn Chi Thành
崔璐才=Thôi Lộ Tài
巫毒会=Vu Độc Hội
差分机=Difference engine(Máy sai phân)
巴尔金=Barkin
巴罗夫=Barov
布兰多=Brando
布朗热=Boulanger
布莱克=Black
布莱妮=Briony
希姆斯=Himes
希尔堡=Fort Sill
希望镇=Hi Vọng Trấn
希里斯=Cialis
希金斯=Higgins
帕索斯=Pasos
帕索洛=Pasolo
席迪思=Sidious
幻梦境=Ảo Mộng Cảnh
康奈尔=Cornell
康纳尔=Conor
异世界=Dị Thế Giới
异乡人=Người Xứ Lạ
弗朗哥=Franco
弗理佩=Flippe
弗莱彻=Fletcher
弗莱明=Flemming
张暗牌=Trương Ám Bài
张特殊=Trương Đặc Thù
张闹鬼=Trương Nháo Quỷ
归一者=Quy Nhất Giả
彭格洛=Bành Cách Lạc
德克特=Decter
德拉克=Drake
德拉尔=Delal
德拉戈=Drago
德维奇=Devic
心理学=Tâm Lý Học
恐怖堡=Kinh Khủng Pháo Đài
恩米尔=Enmir
恩西斯=Ensis
恩霍尔=Enhall
恶灵化=Ác Linh Hóa
恶魔语=Ác Ma Ngữ
戴安娜=Diana
戴尔市=Đái Nhĩ Thị
戴斯蒙=Desmond
戴里克=Derrick
扎坦纳=Zatanna
扎拉斯=Zalas
扎菲尔=Zafir
托尔福=Tolford
托瑞安=Torian
护士像=Hộ Sĩ Tượng
护火者=Hộ Hỏa Giả
拉尼娜=Lanina
拉德斯=Lades
拉德诺=Radnor
拉文德=Lavender
拉格森=Ragson
拉格特=Lagert
拉格莱=Laglet
拉瑟斯=Lassers
拉索娅=Lasoya
拉索德=Rathod
拉美亚=Lamea
拉莱格=Laleg
拉马迪=Ramadi
拉鲁斯=LaRousse
拜伦斯=Barons
提里斯=Tiris
摩尔斯=Morse
撒卡托=Sakato
操偶术=Thao Ngẫu Thuật
操偶者=Thao Ngẫu Giả
收容物=Thu Dung Vật
故事集=Cố Sự Tập
文书级=Văn Thư Cấp
文书记=Văn Thư Ký
文学院=Văn Học Viện
文理论=Văn Lý Luận
文艺报=Văn Nghệ Báo
斐申纳=Fischenna
斯上尉=Tư Thượng Úy
斯卡文=Skaven
斯洛斯=Sloss
斯派洛=Sparrow
斯科特=Scott
斯考特=Scott
新大陆=Tân Đại Lục
新月的=Tân Nguyệt
施卢赫=Schluch
施耐德=Schneider
旁遮普=punjab
旅行门=Lữ Hành Môn
无常的=Vô Thường
旧大陆=Cựu Đại Lục
旧日的=Cựu Nhật
时与空=Thời Cùng Không
时之虫=Thời Chi Trùng
时空龙=Thời Không Long
星之痕=Tinh Chi Ngân
普利夏=Priscia
普洛西=Procy
普霍夫=Pukhov
智天使=Trí Thiên Sứ
智慧的=Trí Tuệ
智者集=Trí Giả Tập
暗影球=Ám Ảnh Cầu
曼迪斯=Mandys
月之影=Nguyệt Chi Ảnh
月之梦=Nguyệt Chi Mộng
月之神=Nguyệt Chi Thần
月光轮=Nguyệt Quang Luân
未来视=Nhìn Thấy Tương Lai
杜拉汗=Dullahan
杜茵河=Duin Sông
杜鲁特=Durut
来金斯=Legins
查内姆=Chanem
查尔斯=Charles
查理德=Charity
柯博尔=Cobble
柯尔摩=Colmore
树之吻=Thụ Chi Vẫn
格列佛=Gulliver
格林岛=Green Đảo
格林湖=hồ Green
格瑞尔=Greer
格蕾塔=Greta
格蕾斯=Grace
格雷福=Grave
桑切斯=Sanchez
桑斯切=Sanchez
梅丽卡=Melica
橡树神=Tượng Thụ Thần
次元斩=Thứ Nguyên Trảm
欧兰诺=Âu Lan Nặc
欧瑞思=Oris
歌剧团=Ca Kịch Đoàn
歌力思=Gloria
死之歌=Tử Chi Ca
残响的=tàn hưởng
段人生=Đoạn Nhân Sinh
毁灭者=Hủy Diệt Giả
比较着=so sánh
毕肖普=Bishop
民俗学=Dân Tục Học
水晶鞋=Giày Thủy Tinh
水银雾=Thủy Ngân Sương Mù
永夜城=Vĩnh Dạ Thành
汉弗莱=Hunphrey
汉格顿=Hangleton
沃森特=Watson
法莉丝=Fallis
法蒂尔=Fatier
法默尔=Farmer
泡头咒=Phao Đầu Chú
泣血者=Khấp Huyết Giả
海伦娜=Helena
海格斯=Hagers
海洛斯=Heros
海盗王=Vua Hải Tặc
海盗船=Thuyền Hải Tặc
混血龙=Hỗn Huyết Long
渎神者=Kẻ Độc Thần
渔民们=các ngư dân
温斯特=Winster
湖心岛=Hồ Tâm Đảo
溺亡者=Nịch Vong Giả
火柴女=Diêm Nữ
灰仓鼠=Hôi Thương Thử
灰头鹰=Hôi Đầu Ưng
灰姑娘=Cô Bé Lọ Lem
灰手套=Hôi Thủ Sáo
灵符文=Linh Phù Văn
炎爆术=Viêm Bạo Thuật
炼金学=Luyện Kim Học
炼金术=Luyện Kim Thuật
爱丽丝=Alice
爱隆河=Elron Sông
特蕾莎=Teresa
特雷斯=Tres
狂雷书=Cuồng Lôi Thư
狄拉克=Dirac
狄更斯=Dickens
独角兽=Độc Giác Thú
猫尾巴=đuôi mèo
玉米杆=cây ngô cái
王尔德=Wilde
玛丽安=Marianne
玛丽珍=Mary Jane
玛丽莲=Marilyn
玛吉斯=Magis
玛库斯=Marcus
环先生=Hoàn Tiên Sinh
环术士=Hoàn Thuật Sĩ
琳修女=Lâm Tu Nữ
瑟维特=Serveit
瑟韦尔=Serwell
瑰丽的=côi lệ
瓦尔希=Varshi
瓦尔达=Varda
瓦拉克=Varak
生命体=Sinh Mệnh Thể
番尼时=Penny
登神术=Đăng Thần Thuật
白天使=Bạch Thiên Sứ
白河谷=Bạch Hà Cốc
皮克曼=Pickman
皮格曼=Pigman
皮罗特=Pilot
真理会=Chân Lý Hội
石之心=Thạch Chi Tâm
石像鬼=Thạch Tượng Quỷ
石巨人=Thạch Cự Nhân
石心魔=Thạch Tâm Ma
石戒指=Thạch Giới Chỉ
破邪斩=Phá Tà Trảm
神学院=Thần Học Viện
神殿的=Thần Điện
神秘学=Thần Bí Học
神秘者=Thần Bí Giả
祭祀的=Tế Tự
福曼斯=Formans
科莱昂=Corleone
穆尔德=Mulder
穆希尔=Muhir
空之痕=Không Chi Ngân
童话镇=Thị Trấn Cổ Tích
第一纪=Đệ Nhất Kỷ
第三纪=Đệ Tam Kỷ
第二纪=Kỷ Thứ Hai
第五名=người thứ năm
第五纪=Đệ Ngũ Kỷ
第六纪=Đệ Lục Kỷ
简短的=ngắn gọn
简花店=Jane Tiệm Hoa
米凯拉=Michaela
米尔雅=Mirya
米德拉=Midra
米德罗=Midlo
米拉尔=Millar
米歇尔=Michelle
精灵文=Tinh Linh Văn
精神体=Tinh Thần Thể
精神力=Tinh Thần Lực
索菲亚=Sophia
紫甘蓝=Tử Cam Lam
红色的=Hồng Sắc
红药水=Hồng Dược Thủy
约克文=York
约德尔=Jodel
约翰逊=Johnson
纯真的=Hồn Nhiên
纳布斯=Nabs
纵火者=Tung Hỏa Giả
纽科伦=Newcolumn
维拉德=Willard
维斯沃=Wiswer
缚日者=Phược Nhật Giả
罗娜尔=Ronal
罗宾森=Robinson
罗德牌=Rhodes Bài
罗思尔=Rosel
罗纳德=Ronald
罪公馆=Tội Công Quán
美人鱼=Mỹ Nhân Ngư
羽毛笔=Feather Pen
翁迪巴=Ondiba
老作家=Lão Tác Gia
老先生=Lão Tiên Sinh
老教士=Lão Giáo Sĩ
老爵士=Lão Tước Sĩ
老神父=Lão Cha Xứ
老约翰=Lão John
老贤者=Lão Hiền Giả
老骑士=Lão Kỵ Sĩ
老魔女=Lão Ma Nữ
考古学=Khảo Cổ Học
考斯特=Coster
考普斯=Copps
舒尔斯=Schulls
舒尔茨=Schultz
艾克迪=Aikedi
艾尔林=Erlin
芈何芈=?
芬丝尼=Finnish
芬内尔=Fennell
荆棘丛=Kinh Cức Tùng
药剂学=Dược Tề Học
药剂师=Dược Tề Sư
莉安娜=Liana
莉法妮=Leifani
莫先生=Mạc tiên sinh
莫古斯=Mogus
莫威尔=Morwell
莫尔迪=Mordi
莫德罗=Modelo
莫泊桑=Mạc Bạc Tang
莫罗德=Morod
莫霍尔=Mohor
莱克顿=Laketon
莱斯特=Leicester
莱茵妖=Lai Nhân Yêu
莱金斯=Legins
菲利普=Philip
菲拉斯=Feralas
菲欧娜=Fiona
菲欧琪=Future
萨克斯=Sax
萨奇亚=Sachia
蒂芬妮=Tiffany
蕾茜雅=Laccia
薇森娜=Visenna
薛诺德=Schnold
藏尸镜=Tàng Thi Kính
藏镜人=Tàng Kính Nhân
藏骨堂=Tàng Cốt Đường
虚假的=Hư Giả
血荆棘=Huyết Kinh Cức
血酿的=Huyết Nhưỡng
衔尾蛇=Hàm Vĩ Xà
衡量物=Hành Lượng Vật
被选者=Bị Tuyển Giả
西卡尔=Seagull
西大陆=Tây Đại Lục
西比尔=Sybill
西科尼=Sicconi
西米尔=Simil
观星台=Quan Tinh Đài
观星者=Quan Tinh Giả
詹伯特=Jambert
记录者=Người Ghi Chép
诅咒物=Nguyền Rủa Vật
诗人冯=Potvon
诗人级=Thi Nhân Cấp
诺洛夫=Nolov
诺贝拉=Nobela
谢尔夫=Cherf
谢帕德=Shepard
贝亚思=Bayas
贝尔松=Belson
贝斯克=Basker
贝雅思=Bayas
贝鲁特=Beirut
贤者级=Hiền Giả Cấp
费利舍=Felischer
赛巴隆=Cybalon
赫尔斯=Hels
超凡者=Siêu Phàm Giả
跃火者=Dược Hỏa Giả
路伯之=Lộ Bá Chi
路瓦茨=Luvac
辛德勒=Schindler
辛普森=Simpson
辛迪亚=Scindia
达拉克=Dalak
迈尔逊=Myerson
迦凯尔=Gakeel
迦迪斯=Caddis
迪乌斯=Deus
迪亚克=Diack
迪斯克=Disick
迪莫克=Dimock
迷失湖=Mê Thất Hồ
追风者=Truy Phong Giả
逐光者=Trục Quang Giả
造物主=Tạo Vật Chủ
邪教徒=Tà Giáo Đồ
里姆特=Rimut
里德尔=Riddle
金威斯=Kim Weiss
金矿村=Mỏ Vàng Thôn
银月斩=Ngân Nguyệt Trảm
银瞳者=Ngân Đồng Giả
银立方=Ngân Lập Phương
银色的=Ngân Sắc
门之钥=Môn Chi Thược
防火女=Phòng Hỏa Nữ
阳光枪=Dương Quang Súng
阿什莉=Ashley
阿夏拉=Ashara
阿尔芒=Armand
阿斯蒙=Asmon
阿普纳=Apna
阿泰克=Arthecker
阿蕾菈=Arela
陆行鸟=Chocobo
隆美尔=Rommel
隐修会=Ẩn Tu Hội
隐秘的=Ẩn Bí
雅各布=Jacob
雅拉汗=Yala Khan
雷杰德=Legend
雷茜雅=Lesia
霍伊尔=Hoyle
霍恩斯=Hoens
露维亚=Luvia
露维娅=Luvia
露薏莎=Louisa
静月光=Tĩnh Nguyệt Quang
项委托=Hạng Ủy Thác
预言家=Dự Ngôn Gia
飞花咒=Phi Hoa Chú
飞针术=Phi Châm Thuật
马吉拉=Majira
马宁伯=Mã Ninh bá
马歇尔=Marshall
马法尔=Mafal
驱魔人=Khu Ma Nhân
驱魔术=Khu Ma Thuật
高炉市=Lò Cao Thành Phố
高迪斯=Gaudís
魔印章=Ma Ấn Chương
魔术师=Ma Thuật Sư
鱼人们=ngư nhân môn
鱼戒指=Ngư Giới Chỉ
麦凯恩=McCain
麦迪斯=Madis
黄宝石=Hoàng Bảo Thạch
黄金人=Hoàng Kim Nhân
黄金色=Hoàng Kim Sắc
黄铜色=Hoàng Đồng Sắc
黄铜龙=Hoàng Đồng Long
黑暗剑=Hắc Ám Kiếm
黑森格=Hessinger
黑渡鸦=Hắc Độ Nha
默克尔=Merkel
黛芙琳=Devlin
龙之书=Long Chi Thư
龙之怒=Long Chi Nộ
龙之血=Long Chi Huyết
龙头形=Long Đầu Hình
龙头石=Long Đầu Thạch
龙皮书=Long Bì Thư
龙血宝=Long Huyết Bảo
一环术士=Nhất Hoàn Thuật Sĩ
七把扫帚=seven broomsticks
七环术士=Thất Hoàn Thuật Sĩ
万物之主=Vạn Vật Chi Chủ
万物平等=Vạn Vật Bình Đẳng
万物归一=Vạn Vật Quy Nhất
万能钥匙=Chìa Khóa Vạn Năng
万象无常=Vạn Tượng Vô Thường
三大奇书=Tam Đại Kỳ Thư
三大学院=Tam Đại Học Viện
上古之音=Thượng Cổ Chi Âm
不可知级=Bất Khả Tri Cấp
不定智者=Bất Định Trí Giả
不死秘术=Bất Tử Bí Thuật
不老秘术=Bất Lão Bí Thuật
不老魔女=Bất Lão Ma Nữ
与你同在=cùng ngươi cùng tồn tại
世界之暗=Thế Giới Chi Ám
世界地图=Thế Giới Địa Đồ
世界末日=Tận Thế
世界毁灭=Thế Giới Hủy Diệt
世界终亡=Thế Giới Chung Vong
中大部分=bên trong đại bộ phận
中环术士=Trung Hoàn Thuật Sĩ
丰收之月=Bội Thu Chi Nguyệt
丰饶领域=Trù Phú Lĩnh Vực
丹妮斯特=Danist
九环术士=Cửu Hoàn Thuật Sĩ
二十三四=23,24
五环术士=Ngũ Hoàn Thuật Sĩ
五神教会=Ngũ Thần Giáo Hội
五神教堂=Ngũ Thần Giáo Đường
亚德莱达=Adelaida
亡灵夜行=Vong Linh Dạ Hành
亡灵天灾=Vong Linh Thiên Tai
亡灵海潮=Vong Linh Hải Triều
亡灵生物=Vong Linh Sinh Vật
亡者苏生=Vong Giả Tô Sinh
亨特利尔=Huntlier
人体炼成=Nhân Thể Luyện Thành
人生仪式=Nhân Sinh Nghi Thức
人生游戏=Nhân Sinh Du Hí
人鱼之歌=Nhân Ngư Chi Ca
从里德尔=từ Riddle
伊曼努斯=Immanus
伊特莱恩=Eatline
伊莎贝拉=Isabella
伏行之暗=Phục Hành Chi Ám
众生皆死=Chúng Sinh Giai Tử
传送通道=Truyền Tống Thông Đạo
低环术士=Thấp Hoàn Thuật Sĩ
光的猎犬=Quang Chó Săn
光耀阴影=Quang Diệu Âm Ảnh
克洛迪艾=Clodie
克莱拉特=Clarat
克雷医生=Clay bác sĩ
八枪上尉=Tám Thương Thượng Úy
六环术士=Lục Hoàn Thuật Sĩ
军情六处=MI6
冥月之下=Minh Nguyệt Chi Hạ
冬日歌者=Đông Nhật Ca Giả
冬眠春生=Đông Miên Xuân Sinh
冰之魔女=Băng Chi Ma Nữ
冻死之人=Đống Tử Chi Nhân
函授学生=Hàm Thụ Học Sinh
创造女士=Sáng Tạo Nữ Sĩ
创造教会=Sáng Tạo Giáo Hội
创造空间=Sáng Tạo Không Gian
初火余烬=Sơ Hỏa Tro Tàn
初生之月=Sơ Sinh Chi Nguyệt
剑斩恶魔=Kiếm Trảm Ác Ma
勇者传说=Dũng Giả Truyền Thuyết
化泥为石=Hóa Bùn Thành Đá
化生戒指=Hóa Sinh Giới Chỉ
化石为泥=Hóa Đá Thành Bùn
化身红蝶=Hóa Thân Hồng Điệp
北方明珠=Bắc Phương Minh Châu
十环术士=Thập Hoàn Thuật Sĩ
千树之森=Forest of Thousand Trees
千目幻蝶=Thiên Mục Huyễn Điệp
升华之典=Thăng Hoa Chi Điển
升华之语=Thăng Hoa Chi Ngữ
升华之路=Thăng Hoa Chi Lộ
半神之路=Bán Thần Chi Lộ
半神魔女=Bán Thần Ma Nữ
南方城市=Phương Nam Thành Thị
占星马人=Chiêm Tinh Mã Nhân
卡拉大道=Kara Đường Lớn
卡拉斯山=Caraz Núi
卡文迪许=Cavendish
卡森德拉=Casendra
卡森里克=Carsonlick
卡珊德拉=Cassandra
卡瑟琳娜=Catharina
厄尔诺克=Ernock
历史学院=Lịch Sử Học Viện
原初之火=Nguyên Sơ Chi Hỏa
原初裂痕=Nguyên Sơ Liệt Ngân
原始力量=Nguyên Thủy Lực Lượng
原罪奇术=Nguyên Tội Kỳ Thuật
双生恋人=Song Sinh Người Yêu
古代文学=Cổ Đại Văn Học
古代童话=Cổ Đại Truyện Cổ Tích
古代符文=Cổ Đại Phù Văn
古代语言=Cổ Đại Ngôn Ngữ
古代邪物=Cổ Đại Tà Vật
古代魔女=Cổ Đại Ma Nữ
古代鱼人=Cổ Đại Ngư Nhân
另一个我=Một Cái Khác Ta
召唤坐骑=Triệu Hoán Tọa Kỵ
召唤石像=Triệu Hoán Tượng Đá
可不太平=cũng không thái bình
各位女士=các vị nữ sĩ
吞月灵猫=Thôn Nguyệt Linh Miêu
吸血之牙=Hấp Huyết Chi Nha
吸血之神=Hấp Huyết Chi Thần
吸血公爵=Hấp Huyết Công Tước
吸血戒指=Hút Máu Giới Chỉ
吾心澄澈=Ta Tâm Trong Suốt
告死天使=Cáo Tử Thiên Sứ
呢喃声音=Nỉ Non Âm Thanh
呢喃诗章=Nỉ Non Bài Thơ
呼唤石像=Kêu Gọi Tượng Đá
命运之子=Vận Mệnh Chi Tử
命运之神= Vận Mệnh Chi Thần
命运之路=Vận Mệnh Chi Lộ
命运之轮=Vận Mệnh Chi Luân
命运基座=Vận Mệnh Cơ Tọa
命运指引=Vận Mệnh Chỉ Dẫn
命运赌场=Vận Mệnh Sòng Bạc
命运轮环= Vận Mệnh Luân Hoàn
命运长河=Vận Mệnh Trường Hà
和平之鸽=Hòa Bình Chim Bồ Câu
和平慈父=Hòa Bình Từ Phụ
和平教会=Hòa Bình Giáo Hội
和平教堂=Hòa Bình Giáo Đường
哈蒂尔斯=Hartels
哭泣天使=Thút Thít Thiên Sứ
唤星魔石=Hoán Tinh Ma Thạch
唤灵术士=Hoán Linh Thuật Sĩ
唤神仪式=Gọi Thần Nghi Thức
善良之枪=Thiện Lương Chi Súng
四环术士=Tứ Hoàn Thuật Sĩ
回溯之时=Hồi Tố Thời Điểm
国王密令=Quốc Vương Mật Lệnh
圣劳伦斯=St. Lawrence
圣拜伦斯=St Barrons
圣树之痕=Thánh Thụ Chi Ngân
圣歌响起=Thánh Ca Vang Lên
圣歌回响=Thánh Ca Vang Vọng
圣歌广场=Anthem Quảng Trường
圣法布里=Thánh Fabri
圣白礼堂=Thánh Bạch Lễ Đường
地心熔炉=Địa Tâm Lò Luyện
地震之神=Địa Chấn Chi Thần
埃尔德隆=Elderlon
塞德里克=Cedric
夜空之月=Dạ Không Chi Nguyệt
大地之力=Đại Địa Chi Lực
大地之心=Đại Địa Chi Tâm
大地之歌=Đại Địa Chi Ca
大地之神=Đại Địa Chi Thần
大地圣杯=Đại Địa Chén Thánh
大地教会=Đại Địa Giáo Hội
大地母神=Đại Địa Mẫu Thần
大地污染=Đại Địa Ô Nhiễm
大地熔炉=Đại Địa Lò Luyện
大地记忆=Đại Địa Ký Ức
大城玩家=Đại Thành Người Chơi
大罪之魔=Đại Tội Chi Ma
大罪符文=Đại Tội Phù Văn
大罪锁链=Đại Tội Xiềng Xích
天使之王=Thiên Sứ Chi Vương
天使光环=Thiên Sứ Quang Hoàn
天文学院=Thiên Văn Học Viện
太阳之力=Thái Dương Chi Lực
太阳之子=Thái Dương Chi Tử
太阳之火=Thái Dương Chi Hỏa
太阳教会=Thái Dương Giáo Hội
太阳教堂=Thái Dương Giáo Đường
太阳教廷=Thái Dương Giáo Đình
太阳纹章=Thái Dương Văn Chương
奇切斯特=Chichester
奥森弗特=Oxenfurt
女仆小姐=Nữ Bộc Tiểu Thư
女占卜家=Nữ Chiêm Bặc Gia
威伦戴尔=Willendale
威廉姆特=Williamt
威纶戴尔=Willendale
存在之力=Tồn Tại Chi Lực
守密人级=Thủ Mật Nhân Cấp
守密导师=Thủ Bí Đạo Sư
守秘导师=Keeper of Secrets(Thủ Bí Đạo Sư)
安吉利斯=Angeles
官米拉尔=Milal
寂静月光=Silent Moonlight
富兰克林=Franklin
寒冬圣歌=Hàn Đông Thánh Ca
寒冬少女=Hàn Đông Thiếu Nữ
寒冬教团=Hàn Đông Giáo Đoàn
小斐申纳=tiểu Fischenna
小杜拉汗=Dullahan
小菲利普=tiểu Phillip
小蕾茜雅=tiểu Lesia
小酒馆的=tiểu tửu quán
尘世巨蟒=Trần Thế Cự Mãng
尘土之神=Trần Thổ Chi Thần
岁月之息=Tuế Nguyệt Chi Tức
巧克力的=Chocolate
巫毒会的=Vu Độc Hội
布莱切特=Brecht
希顿法印=Hilton Pháp Ấn
平静姿态=Bình Tĩnh Tư Thái
广场六号=Quảng Trường Số Sáu
库布里克=Kubrick
开拓之风=Khai Thác Chi Phong
弗朗索瓦=François
强大魔女=Cường Đại Ma Nữ
归还之火=Quy Hoàn Chi Hỏa
影随黎明=Ảnh Tùy Lê Minh
彼特拉克=Petrarch
德拉瑞昂=Delarion
德林奥尔=Drinoul
心灵之光=Tâm Linh Chi Quang
心灵炼金=Tâm Linh Luyện Kim
心灵窥镜=Tâm Linh Khuy Kính
心灵结晶=Tâm Linh Kết Tinh
心灵能力=Tâm Linh Năng Lực
心灵震爆=Mind Blast
心理医生=Bác Sĩ Tâm Lý
心绪之戒=Tâm Tự Chi Giới
怨念之种=Oán Niệm Chi Chủng
恐怖故事=Kinh Khủng Cố Sự
恩里克斯=Enriquez
恶念教会=Ác Niệm Giáo Hội
恶魂之血=Ác Hồn Chi Huyết
恶魔专家=Ác Ma Chuyên Gia
恶魔之书=Ác Ma Chi Thư
恶魔之岛=Ác Ma Chi Đảo
恶魔之王=Ác Ma Chi Vương
恶魔之血=Ác Ma Chi Huyết
恶魔学者=Ác Ma Học Giả
恶魔故事=Ác Ma Cố Sự
恶魔武器=Ác Ma Vũ Khí
恶魔炸弹=Ác Ma Bom
恶魔金币=Ác Ma Kim Tệ
悲伤歌剧=Bi Thương Ca Kịch
悲剧歌剧=Bi Kịch Ca Kịch
愚者之书=Ngu Giả Chi Thư
感知时间=Cảm Tri Thời Gian
愿望恶魔=Nguyện Vọng Ác Ma
成人教育=giáo dục bổ túc
战神广场=Chiến Thần Quảng Trường
扎拉斯文=Zalas
托德尔斯=Todels
托贝斯克=Tobesk
指引之月=Chỉ Dẫn Chi Nguyệt
指引死亡=Chỉ Dẫn Tử Vong
提灯老人=Đề Đăng Lão Nhân
播种之月=Gieo Hạt Chi Nguyệt
撼地蠕虫=Hám Địa Nhuyễn Trùng
政治经济=Chính Trị Kinh Tế
数学学院=Số Học Học Viện
文明之光=Văn Minh Chi Quang
斯坦先生=Stane Tiên Sinh
斯莫威尔=Smallwell
施卢赫湖=Lake Schluch
旅者之神=Lữ Giả Chi Thần
旅途之神=Lữ Đồ Chi Thần
无光冠冕=Vô Quang Mũ Miện
无名之龙=Vô Danh Chi Long
无垠空间=Vô Ngân Không Gian
无夏之年=Vô Hạ Chi Niên
无头小丑=Không Đầu Thằng Hề
无头骑士=Kỵ Sĩ Không Đầu
无形之子=Vô Hình Chi Tử
无知之海=Vô Tri Chi Hải
无限时光=Vô Hạn Thời Gian
日光射线=Nhật Quang Xạ Tuyến
日月星辰=Nhật Nguyệt Tinh Thần
旧日之神=Cựu Nhật Chi
沙... 沙... 沙=Sa... Sa... Sa
夫妻夜晚同床共枕前必修=Vợ Chồng Ban Đêm Cùng Giường Chung Gối Bắt Buộc Trước
当 —— 当 —— 当=C-O-O-O-N-G —— C-O-O-O-N-G —— C-O-O-O-N-G
王嫚=Vương Mạn
苏苏姑娘=Tô Tô cô nương
孙白石=Tôn Bạch Thạch
陈警官=cảnh sát Trần
陈志云=Trần Chí Vân
顾珂=Cố Kha
陈队=Trần đội
白秋铃=Bạch Thu Linh
郑薇=Trịnh Vi
孙慕晴=Tôn Mộ Tình
慕晴=Mộ Tình
陈轻竹=Trần Khinh Trúc
周医生=bác sĩ Chu
苏彦舒=Tô Ngạn Thư
张硕年=Trương Thạc Niên
赵寰熙=Triệu Hoàn Hi
血鼠=chuột máu
青禾医院=bệnh viện Thanh Hòa
私立青禾医院=bệnh viện tư nhân Thanh Hòa
素心姐姐=Tố Tâm tỷ tỷ
冯俊年=Phùng Tuấn Niên
嫣姐=Yên tỷ
萌萌=Manh Manh
苏木禾=Tô Mộc Hòa
阮萌萌=Nguyễn Manh Manh
楚嫣=Sở Yên
安素心=An Tố Tâm
楚宵=Sở Tiêu
【 太古意气诀 】=【 Thái Cổ Khí Quyết 】
中天境高手=Trung Thiên Cảnh cao thủ
仕女捕蝶图=Sĩ Nữ Bộ Điệp Đồ
千里江山图=Thiên Lý Giang Sơn Đồ
宇文承朝=Vũ Văn Thừa Triều
宇文承陵=Vũ Văn Thừa Lăng
南宫倾城=Nam Cung Khuynh Thành
康州=Khang Châu
孟神=Mạnh Thần
石观=Thạch Quan
癸派=Quý Phái
刀教=Đao Giáo
神刀教=Thần Đao Giáo
山派=Sơn Phái
筋经=Cân Kinh
五宗=Ngũ tông
明拳=Minh Quyền
林寺=Lâm Tự
楚留=Sở Lưu
明却=Minh Khước
胡铁花=Hồ Thiết Hoa
江盟=Giang Minh
厉胜=Lệ Thắng
铁心苦=Thiết Tâm Khổ
左丘伊人=Tả Khâu Y Nhân
石之=Thạch Chi
柳若松=Liễu Nhược Tùng
方明=Phương Minh
黎世嵩=Lê Thế Tung
孙小=Tôn Tiểu
祝玉=Chúc Ngọc
李寻=Lý Tầm
徐子=Từ Tử
明身=Minh Thân
韩小=Hàn Tiểu
岳云=Nhạc Vân
谢小=Tạ Tiểu
谢小玉=Tạ Tiểu Ngọc
明脸=Minh Kiểm
龙标=Long Tiêu
明不=Minh Bất
朱七七=Chu Thất Thất
王龙标=Vương Long Tiêu
千绝=Thiên Tuyệt
屠千绝=Đồ Thiên Tuyệt
大乾太=Đại Càn Thái
袁承=Viên Thừa
师妃=Sư Phi
李世=Lý Thế
段正=Đoạn Chính
金世遗=Kim Thế Di
阳锋=Dương Phong
唐晓澜=Đường Hiểu Lan
铁翅=Thiết Sí
铁翅天鹰=Thiết Sí Thiên Ưng
熊猫儿=Hùng Miêu Nhi
贺人龙=Hạ Nhân Long
黎彩凤=Lê Thải Phượng
大乾太子=Đại Càn Thái Tử
厉盼归=Lệ Phán Quy
谢晓=Tạ Hiểu
林铃铃=Lâm Linh Linh
周通=Chu Thông
宁道=Ninh Đạo
林仙=Lâm Tiên
张顶天=Trương Đỉnh Thiên
薛笑人=Tiết Tiếu Nhân
明大=Minh Đại
霍青=Hoắc Thanh
慈航静=Từ Hàng Tĩnh
高升泰=Cao Thăng Thái
秋素素=Thu Tố Tố
千仞=Thiên Nhận
萧远=Tiêu Viễn
裘千=Cừu Thiên
铁佛=Thiết Phật
黑珍=Hắc Trân
铁佛尊者=Thiết Phật Tôn Giả
方灵=Phương Linh
明还=Minh Hoàn
夏侯营=Hạ Hầu Doanh
原随=Nguyên Tùy
云子=Vân Tử
明之=Minh Chi
风翎子=Phong Linh Tử
宋师=Tống Sư
连如=Liên Như
连如意=Liên Như Ý
白飞=Bạch Phi
明有=Minh Hữu
商清雅=Thương Thanh Nhã
清雅=Thanh Nhã
大乾世界=Đại Càn Thế Giới
水母阴姬=Thủy Mẫu Âm Cơ
吴陆奇=Ngô Lục Kỳ
黄药=Hoàng Dược
原著=Nguyên Trứ
阎本初=Diêm Bản Sơ
雷刑天=Lôi Hình Thiên
王怜=Vương Liên
明摸=Minh Mạc
薛衣=Tiết Y
金无望=Kim Vô Vọng
阴煞功=Âm Sát Công
青萝=Thanh La
李秋=Lý Thu
杨允贤=Dương Doãn Hiền
巴天石=Ba Thiên Thạch
端木赐=Đoan Mộc Tứ
赵天君=Triệu Thiên Quân
明可=Minh Khả
鲁妙=Lỗ Diệu
姬晓风=Cơ Hiểu Phong
童月嫦=Đồng Nguyệt Thường
林玉彤=Lâm Ngọc Đồng
岳不=Nhạc Bất
岳鹏=Nhạc Bằng
薛玲玲=Tiết Linh Linh
阎立三=Diêm Lập Tam
大高=Đại Cao
明很=Minh Ngận
隋军=Tùy Quân
子中=Tử Trung
子穆=Tử Mục
宫灵=Cung Linh
明正=Minh Chính
万花夫=Vạn Hoa Phu
铁燕=Thiết Yến
完颜洪=Hoàn Nhan Hồng
敖无虚=Ngao Vô Hư
谷之华=Cốc Chi Hoa
颜洪烈=Nhan Hồng Liệt
大光=Đại Quang
王处=Vương Xử
江南七怪=Giang Nam Thất Quái
左轻侯=Tả Khinh Hầu
秀野桥=cầu Tú Dã
楚凤郡=Sở Phượng quận
云梦仙子=Vân Mộng tiên tử
全真七子=Toàn Chân thất tử
齿铁锏=Xỉ Thiết giản
田一飞=Điền Nhất Phi
云海玉弓缘=Vân Hải Ngọc Cung Duyên
云海玉弓=Vân Hải Ngọc Cung
闵子华=Mẫn Tử Hoa
十力大师=Thập Lực đại sư
云十四煞=Vân Thập Tứ Sát
刘培生=Lưu Bồi Sinh
梅剑=Mai Kiếm
星宿老人=Tinh Túc lão nhân
玄慈=Huyền Từ
凌慕华=Lăng Mộ Hoa
孟尝=Mạnh Thường
欧阳喜=Âu Dương Hỉ
冷二=Lãnh Nhị
郑彩娘=Trịnh Thải Nương
霍丘=Hoắc Khâu
霍丘三凶=Hoắc Khâu Tam Hung
大先天高手=Đại Tiên Thiên cao thủ
花万紫=Hoa Vạn Tử
王小虎=Vương Tiểu Hổ
九天手=Cửu Thiên Thủ
神龙剑客=Thần Long kiếm khách
寻欢=Tầm Hoan
幽萍=U Bình
蝙蝠岛=Biên Bức đảo
游骥=Du Ký
平丘县城=Bình Khâu huyện thành
御赐佛像=Ngự Tứ Phật Tượng
苏副统领=Tô phó thống lĩnh
金钩赌坊=Kim Câu Đổ Phường
长信狼兵=Trường Tín Lang binh
刘文轩=Lưu Văn Hiên
狼突=Lang Đột
大鹏=Đại Bằng
长信狼骑=Trường Tín Lang Kỵ
长岭山脉=Trường Lĩnh sơn mạch
隆和商队=Long Hòa thương đội
隆和贸易=Long Hòa Mậu Dịch
丁子修=Đinh Tử Tu
中天境=Trung Thiên Cảnh
何队正=Hà đội trưởng
刘维轩=Lưu Văn Hiên
卢队正=Lư đội trưởng
哈尼孜=Cáp Ni Tư
唐人市=Đường Nhân Thị
孟子墨=Mạnh Tử Mặc
孟布居=Mạnh Bố Cư
宁五哥=Ninh Ngũ Ca
宁志峰=Ninh Chí Phong
平丘县=Bình Khâu huyện
平逆军=Bình Nghịch Quân
庞师傅=Bàng sư phó
弘大哥=Hoằng Đại Ca
张树宝=Trương Thụ Bảo
扫了兴=Tảo Liễu Hưng
木头巷=Mộc Đầu ngõ 
杜鸿盛=Đỗ Hồng Thịnh
枫叶楼=Phong Diệp Lâu
沈药师=Thẩm Dược Sư
沐夜姬=Mộc Dạ Cơ
火字骑=Hỏa Kỵ
王骑校=Vương kỵ hiệu
琼夫人=Quỳnh phu nhân
甄侯府=Chân Hầu phủ
甄煜江=Chân Dục Giang
甲字监=Giáp Tự Giám
白狼城=Bạch Lang thành
白狼王=Bạch Lang Vương
白狼部=Bạch Lang bộ
白狼骑=Bạch Lang Kỵ
白虎营=Bạch Hổ doanh
知命院=Tri Mệnh Viện
紫衣监=Tử Y Giám
罗游侠=La du hiệp
罗骑校=La kỵ hiệu
耿骑校=Cảnh Kỵ Hiệu
袁尚羽=Viên Thượng Vũ
逍遥居=Tiêu Dao Cư
郎申水=Lang Thân Thủy
金疮药=Kim Sang Dược
金瘦子=Kim Sấu Tử
长信侯=Trường Tín Hầu
陈瘸子=Trần Qua Tử
陈芝泰=Trần Chi Thái
韩雨农=Hàn Vũ Nông
马料场=mã liệu trận
驻马湖=Trú Mã Hồ
鸡公峡=Kê Công Hạp
黑霸王=Hắc Bá Vương
严青=Nghiêm Thanh
兀陀=Ngột Đà
六子=Lục Tử
刘影=Lưu Ảnh
剿匪=Tiễu Phỉ
史陵=Sử Lăng
图荪=Đồ Tôn
坎叔=Khảm Thúc
大宛=Đại Uyển
奉甘=Phụng Cam
孟舅=Mạnh Cữu
宋闯=Tống Sấm
憨伯=Hàm Bá
承朝=Thừa Triều
汗王=Hãn Vương
漠西=Mạc Tây
牛志=Ngưu Chí
王逍=Vương Tiêu
甄家=Chân Gia
甄郡=Chân Quận
田家=Điền Gia
秦逍=Tần Tiêu
窦家=Đậu Gia
精绝=Tinh Tuyệt
红叶=Hồng Diệp
羊娃=Dương Oa
老田=lão Điền
耿绍=Cảnh Thiệu
芝泰=Chi Thái
苏晁=Tô Triều
虎山=Hổ Sơn
费凉=Phí Lương
赤果=Xích Quả
赵毅=Triệu Nghị
郭旺=Quách Vượng
长义=Trường Nghĩa
长信=Trường Tín
长岭=Trường Lĩnh
长胜=Trường Thắng
陈鹤=Trần Hạc
骑校=kỵ hiệu
龟城=Quy Thành
戴胜=Đới Thắng
凌子霄=Lăng Tử Tiêu
赵大勇=Triệu Đại Dũng
温不道=Ôn Bất Đạo
王申=Vương Thân
孟宇=Mạnh Vũ
阳城=Dương Thành
刘竹竿=Lưu Trúc Can
夏城=Hạ thành
墨水=Mặc Thủy
十六字真言=Thập Lục Tự Chân Ngôn
莹莹=Oánh Oánh
羊牯=Dương Cổ
河武区=khu Hà Vũ
蓝湾社区=khu Lam Loan Xã
八子=Bát Tử
怒儿=Nộ nhi
顾仑=Cố Lôn
歧城=Kỳ Thành
铜铃大=Đồng Linh Đại
王钰=Vương Ngọc
白鹭=Bạch Lộ
徐凯=Từ Khải
刘陆=Lưu Lục
吕德里=Ludely
素玄道长=Tố Huyền đạo trường
大启国=nước Đại Khải
贞武=Trinh Vũ
魏不器=Ngụy Bất Khí
魏玦=Ngụy Quyết
叶腾=Diệp Đằng
神女录 》=Thần Nữ Lục 》
虞夏界=Ngu Hạ Giới
不器=Bất Khí
林灼月=Lâm Chước Nguyệt
大启=Đại Khải
初启第一天关=Sơ Khải Đệ Nhất Thiên Quan
月盏=Nguyệt Trản
魏子期=Ngụy Tử Kỳ
蛇头山=Xà Đầu Sơn
山蜘蛛=Sơn Tri Chu
灌县=Quán huyện
保正徐=Bảo Chính Từ
癞张飞=Lại Trương Phi
葛爷爷=Cát gia gia
山王八=núi Vương Bát
藤非=Đằng Phi
苏炜=Tô Vĩ
摸金笔记 =Mạc Kim Bút Ký
子期=Tử Kỳ
衡先生=Hoành tiên sinh
苏编辑=Tô biên tập
艾艺=Ngải Nghệ
申城=Thân thành
罗坟山=La Phần sơn
葛二秃子=Cát nhị ngốc tử
武大有=Vũ Đại Hữu
衡水帮=Hoành Thủy bang
没尾巴=Một Vĩ Ba
飞飞=Phi Phi
徐崇道=Từ Sùng Đạo
云浣纱=Vân Hoán Sa
綦县=Kỳ huyện
艺艺=Nghệ Nghệ
邵初窈=Thiệu Sơ Yểu
摸金笔记=Mạc Kim Bút Ký
余乾=Dư Càn
李念香=Lý Niệm Hương
宫庭之=Cung Đình Chi
夏听雪=Hạ Thính Tuyết
崔采=Thôi Thải
宫侍郎=Cung thị lang
狮子骢=Sư Tử Thông
窈窈=Yểu Yểu
夹总=Giáp Tổng
爱艺=Ái Nghệ
义威=Nghĩa Uy
藤飞小说=Đằng Phi tiểu thuyết
藤飞小说网=Đằng Phi tiểu thuyết mạng
庄询=Trang Tuân
司琴宓=Ti Cầm Mật
司琴=Ti Cầm
轮转王陛下=Luân Chuyển Vương
还阳=Hoàn Dương
虞山=Ngu sơn
念香=Niệm Hương
朝山陵的后方驶去=chạy về phía sau núi
巫山云雨=vu sơn mây mưa
余连=Dư Liên
希里卡=Hilica
新玉门=Tân Ngọc Môn
铁王领=Thiết Vương Lĩnh
帕顿=Mạt Đốn/Patton
蒙德森=Mundson
橙底=tranh để
艾阿姨=Ngải a di
顾清远=Cố Thanh Viễn
比恩=Beane
刺蛇=Thứ Xà
唐·鲁索=Don Russo
鲁索=Russo
巴卡=Barca
波拿巴=Bonapart
图隆港=Đồ Long cảng
恐爪=Khủng Trảo/Dreadclaw
荆棘蛇王=Kinh Cức Xà vương
绿庭湾=Lục Đình vịnh
丰饶星=Phong Nhiêu tinh
沙扎比=Shazabi
龙虫=Long trùng
八爪大蜘蛛=nhện khổng lồ tám chân
郦小姐=Ly tiểu thư
黄熙=Hoàng Hi
郦茹姒=Ly Như Tự
钱全安=Tiền Toàn An
庄孝廉=Trang Hiếu Liêm
尹都=Doãn Đô
茹姒=Như Tự
询=Tuân
青花白=Thanh Hoa Bạch
景德路=đường Cảnh Đức
吴市=thành phố Ngô
张帅=Trương Soái
城南=thành Nam
景业坊=Cảnh Nghiệp Phường
景业坊的客栈=khách sạn Cảnh Nghiệp Phường
牛半城=Ngưu Bán Thành
虞王=Ngu Vương
沈练=Thẩm Luyện
杨相=Dương Tương
幽国=U quốc
成虞=Thành Ngu
岩蜈蚣=Nham rết
砾龙=Lịch Long
跳虫=Khiêu trùng
恐虫=Khủng trùng
纹章机=Văn Chương Cơ
鱼小婉=Ngư Tiểu Uyển
龟丞相=Quy thừa tướng
强哥=Cường ca
鱼小强=Ngư Tiểu Cường
太安=Thái An
祖鞍=Tổ An
牛府=Ngưu phủ
织女娘娘=Chức Nữ nương nương
织女=Chức Nữ
薛大家=Tiết đại gia
牛氏=Ngưu thị
亚运村=Á Vận thôn
牛乌=Ngưu Ô
裴江军满堂势=Bùi Giang Quân Mãn Đường Thế
图隆=Đồ Long
科米纳=Comina
新诺达尔=Tân Nodal
诺达尔=Nodal
沙民=Sa dân
聆听者=Linh Thính Giả
吴清晨=Ngô Thanh Thần
江县=Giang huyện
陈淼=Trần Miểu
淼淼=Miểu Miểu
牛秀才=Ngưu tú tài
铁罗=Thiết La
季明明=Quý Minh Minh
槐诗=Hòe Thi
叶雪涯=Diệp Tuyết Nhai
顾越=Cố Việt
高浩=Cao Hạo
李子平=Lý Tử Bình
李小平=Lý Tiểu Bình
圣文森特及格林纳丁斯=Thánh Vincent và Grenadines
列昂尼得=Leonidas
马希拉=Mahira
伊兹密尔=Izmir
李教员=Lý giáo viên
希尼卡=Shenika
金港=Kim Cảng
帕拉梅拉=Panamera
小彭=Tiểu Bành
冯彬=Phùng Bân
君望北=Quân Vọng Bắc
恒隆广场=quảng trường Hằng Long
帝都=Đế đô
艾女王=Ngải nữ vương
琦琦=Kỳ Kỳ
王璐=Vương Lộ
张正=Trương Chính
吉磊=Cát Lỗi
磊哥=Lỗi ca
小龙=Tiểu Long
叔本华=Arthur Schopenhauer
陈刀仔=Trần Đao Tử
谢顶=Tạ Đỉnh
BT 币=Bitcoin
冠希哥=Quan Hi Ca
正哥=Chính ca
江河=Giang Hà
王齐=Vương Tề
张素玄=Trương Tố Huyền
马卢达=Malouda
琼斯教授=Jones giáo sư
帝芮罗=Đế Nhuế La
贝亚人=ngưới Baya
李悦=Lý Duyệt
初窈=Sơ Yểu
胡秋媛=Hồ Thu Viện
黄思佳=Hoàng Tư Giai
丁一晨=Đinh Nhất Thần
艺姐=Nghệ tỷ
一晨=Nhất Thần
锐哥=Duệ ca
哲哥=Triết ca
艾禹哲=Ngải Vũ Triết
后海=Hậu Hải
三里屯=Tam Lý Truân
婉昕=Uyển Hân
潘家园=Phan gia viên
滇省=tỉnh Điền
芒市=Mang thị
王野=Vương Dã
少芸=Thiếu Vân
张大力=Trương Đại Lực
白修业=Bạch Tu Nghiệp
缝合怪=Phùng Hợp Quái
落星手=Lạc Tinh Thủ
林歌=Linga
耐瑟尔=Naiseer
八幡弓=Bát Phiên Cung
山姥=Sơn Mụ
绝地天通=Tuyệt Địa Thiên Thông
十握剑=Thập Ác Kiếm
小野=Tiểu Dã
北医六院=Bắc Y Lục viện
萧山机场=sân bay Tiêu Sơn
丽斯卡尔顿=Liz Carlton
尹吉=Doãn Cát
尹吉甫=Doãn Cát Phủ
吴大澄=Ngô Đại Trừng
方浚益=Phương Tuấn Ích
郭沫若=Quách Mạt Nhược
艾嵩=Ngải Tung
西泠=Tây Linh
鲁省=tỉnh Lỗ
四联集团=tập đoàn Tứ Liên
邵清文=Thiệu Thanh Văn
李雯英=Lý Văn Anh
闽省=Mân tỉnh
彭总编=Bành tổng biên
杨沅=Dương Nguyên
临安城=thành Lâm An
後市街=phố Hậu Thị
班荆馆=Ban Kinh quán
颜敏=Nhan Mẫn
乌古论盈歌=Ô Cổ Luận Doanh Ca
盈歌=Doanh Ca
有求司=Hữu Cầu ti
孙勇=Tôn Dũng
白毒虫=Bạch Độc Trùng
山寺=Sơn Tự
六式秘剑=Lục Thức Bí Kiếm
天城坊=Thiên Thành Phường
乌古论=Ô Cổ Luận
乌古论家=Ô Cổ Luận gia
完颜屈=Hoàn Nhan Khuất
天申节=Thiên Thân Tiết
信王=Tín vương
完颜徵=Hoàn Nhan Trưng
临安=Lâm An
皋亭山=núi Cao Đình
黄鹤山=núi Hoàng Hạc
佛日山=núi Phật Nhật
管勾往来国信所=Quản Câu Vãng Lai Quốc Tín Sở
主管往来国信所=Chủ Quản Vãng Lai Quốc Tín Sở
允元堂=Doãn Nguyên đường
秦相=Tần tướng
完颜屈行=Hoàn Nhan Khuất Hành
秦长脚=Tần Trường Cước
机速房=Cơ Tốc phòng
皇城司=Hoàng Thành ti
秦埙=Tần Huân
锁厅试=Tỏa Sảnh thí
秦熺=Tần Hi
街道司=Nhai Đạo ti
石牌坊=Thạch Bài phường
于吉光=Vu Cát Quang
计氏=Kế thị
宋老实=Tống Lão Thực
宋鹿溪=Tống Lộc Khê
杨澈=Dương Triệt
杨大官人=Dương đại quan nhân
鹿溪=Lộc Khê
乐春郡=quận Nhạc Xuân
明伦县=huyện Minh Luân
王大善人=Vương đại thiện nhân
演武令=Diễn Võ Lệnh
王成=Vương Thành
王大亨=Vương Đại Hanh
人中=Nhân Trung
涌泉=Dũng Tuyền
阳谷=Dương Cốc
回春堂=Hồi Xuân đường
七种武器=Thất Chủng Vũ Khí
半侠=Bán Hiệp
鲁国=Lỗ Quốc
鳌少保=Ngao Thiếu Bảo
九图六坐像身法=Cửu Đồ Lục Tọa Tượng Thân Pháp
净空=Tịnh Không
澄智=Trừng Trí
净明=Tịnh Minh
晦明=Hối Minh
破戒刀法=Phá Giới Đao Pháp
王印=Vương Ấn
十里坡=Thập Lý Pha
封羽=Phong Vũ
铜印捕快=Đồng Ấn bộ khoái
铜印捕头=Đồng Ấn bộ đầu
玄真道=Huyền Chân đạo
倾城=Khuynh Thành
还真观=Hoàn Chân quan
崔凌=Thôi Lăng
天枫真人=Thiên Phong chân nhân
坐忘心经=Tọa Vong Tâm Kinh
十七师兄=Thập Thất sư huynh
十七师弟=Thập Thất sư đệ
刘舟=Lưu Chu
崔希敏=Thôi Hi Mẫn
黄真=Hoàng Chân
龙德=Long Đức
荣老=Vinh lão
荣彩=Vinh Thải
程朱理=Trình Chu Lý
马士英=Mã Sĩ Anh
秋山=Thu Sơn
五丁手=Ngũ Đinh Thủ
孙仲君=Tôn Trọng Quân
洪胜海=Hồng Thắng Hải
希敏=Hi Mẫn
黄台吉=Hoàng Đài Cát
黄真兄弟=Hoàng Chân Huynh Đệ
鸭形拳=Áp Hình quyền
沙天广=Sa Thiên Quảng
永胜=Vĩnh Thắng
董开山=Đổng Khai Sơn
董镖头=Đổng tiêu đầu
张若谷=Trương Nhược Cốc
孟伯飞=Mạnh Bá Phi
归二娘=Quy Nhị Nương
仲君=Trọng Quân
碎玉拳=Toái Ngọc quyền
小归钟=Tiểu Quy Chung
皇台吉=Hoàng Đài Cát
金刀少主=Kim Đao thiếu chủ
玉容凤=Ngọc Dung Phượng
三角眼=Tam Giác Nhãn
洋河城=Dương Hà thành
洋河郡=Dương Hà quận
长河帮=Trường Hà bang
玉培新=Ngọc Bồi Tân
大昌河干道=Đại Xương Hà Cán Đạo
连护法=Liên hộ pháp
如影随形的身法=Như Ảnh Tùy Hình Thân Pháp
眼儿媚=Nhãn Nhi Mị
虎威武馆=Hổ Uy võ quán
张青松=Trương Thanh Tùng
青松=Thanh Tùng
沧海月明珠=Thương Hải Nguyệt Minh Châu
伏虎拳=Phục Hổ Quyền
杨慧=Dương Tuệ
左如意=Tả Như Ý
方灵月=Phương Linh Nguyệt
融骨法=Dung Cốt Pháp
杨威武馆=Dương Uy võ quán
杨震威=Dương Chấn Uy
沈凡=Thẩm Phàm
东方馆主=Đông Phương quán chủ
东方教头=Đông Phương giáo đầu
杨威=Dương Uy
张少侠=Trương thiếu hiệp
林教头=Lâm giáo đầu
金崇虎=Kim Sùng Hổ
三合城=thành Tam Hợp
洋河武林=Dương Hà võ lâm
洋河=Dương Hà
飘香苑=Phiêu Hương Uyển
风月行=Phong Nguyệt Hành
连大姐=Liên đại tỷ
三合分舵=Tam Hợp phân đà
灵月=Linh Nguyệt
大江盟=Đại Giang Minh
凝霜剑道=Ngưng Sương kiếm đạo
如是寺=chùa Như Thị
染香=Nhiễm Hương
王柴玉关=Vương Sài Ngọc Quan
秦葭月=Tần Gia Nguyệt
搬三山=Bàn Tam Sơn
尺玉=Xích Ngọc
姜议员=Khương nghị viên
王友贵=Vương Hữu Quý
亚修=Ash
姜育东=Khương Dục Đông
弗蕾德莉卡=Frederica
荀方=Tuân Phương
城坊=Thành Phường
快活王=Khoái Hoạt Vương
白云牧女=Bạch Vân Mục Nữ
沁阳=Thấm Dương
神眼鹰=Thần Nhãn Ưng
方千里=Phương Thiên Lý
李挺=Lý Đĩnh
穿云雁=Xuyên Vân Nhạn
易如风=Dịch Như Phong
展英松=Triển Anh Tùng
铁化鹤=Thiết Hóa Hạc
风林三鸟=Phong Lâm Tam Điểu
崆峒双鞭=Không Động Song Tiên
七七小姐=Thất Thất tiểu thư
范汾阳=Phạm Phần Dương
幽灵宫主=U Linh cung chủ
祂麻烦=Tha Ma Phiền
麻三=Ma Tam
三姑=Tam Cô
铁指禅功=Thiết Chỉ Thiền Công
苏妙依=Tô Diệu Y
见山城=thành Kiến Sơn
春雨巷=hẻm Xuân Vũ
夏若雨=Hạ Nhược Vũ
夏若水=Hạ Nhược Thủy
夏道友=Hạ đạo hữu
若水=Nhược Thủy
若雨=Nhược Vũ
玉清门=Ngọc Thanh Môn
宋室南迁=Tống Thất Nam Thiên
陈汤=Trần Thang
汉兵=Hán binh
铁鹞子=Thiết Diêu Tử
陌上花=Mạch Thượng Hoa
成吧=được rồi
钱程=Tiền Trình
东夏谱系=Đông Hạ Phổ Hệ
石舟=Thạch Chu
旋纲蹑九星=Toàn Cương Nhiếp Cửu Tinh
七七=Thất Thất
仁义庄=Nhân Nghĩa trang
李长青=Lý Trường Thanh
催心掌=Thôi Tâm chưởng
五毒手=Ngũ Độc Thủ
徐若愚=Từ Nhược Ngu
巧手兰心=Xảo Thủ Lan Tâm
花四姑=Hoa Tứ Cô
乔五=Kiều Ngũ
天龙寺天法=Thiên Long Tự Thiên Pháp
玄都观=Huyền Đô Quan
断虹子=Đoạn Hồng Tử
韩伶=Hàn Linh
酒使=tửu sứ
猫儿兄弟=Miêu Nhi huynh đệ
陆上陶朱=Lục Thượng Đào Chu
左公龙=Tả Công Long
欧阳轮=Âu Dương Luân
单弓=Đơn Cung
天法大师=Thiên Pháp đại sư
幽灵鬼窟=U Linh Quỷ Quật
雄州=Hùng Châu
机宜司=Cơ Nghi ti
国信所=Quốc Tín sở
沐丝=Mộc Ti
李押班=Lý giám sát
沐押班=Mộc giám sát
花茶坊=Hoa Trà Phường
张大队长=Trương đại đội trưởng
帕里克=Parik
维尔巴特=Wilbert
弗雷德莉卡=Frederica
沙达克=Shadak
洛慎=Lạc Thận
高小虫=Cao Tiểu Trùng
钱公泰=Tiền Công Thái
刃心大师=Nhận Tâm đại sư
天云令=Thiên Vân Lệnh
云梦令=Vân Mộng Lệnh
柴玉关=Sài Ngọc Quan
金不换=Kim Bất Hoán
铁剑先生=Thiết Kiếm tiên sinh
小湖镇=Tiểu Hồ trấn
陈宗=Trần Tông
虎形=Hổ Hình
虎声=Hổ Thanh
虎势=Hổ Thế
陈正堂=Trần Chính Đường
宗哥=Tông ca
完颜雍=Hoàn Nhan Ung
荆湖=Kinh Hồ
杨治=Dương Trị
葛王=Cát vương
完颜宗敏=Hoàn Nhan Tông Mẫn
郁州=Úc Châu
千佛寺=Thiên Phật Tự
典座=Điển Tọa
寮元=Liêu Nguyên
维那=Duy Na
余云寺=chùa Dư Vân
张渊=Trương Uyên
褚峥=Chử Tranh
罗娴=La Nhàn
辉业城=thành Huy Nghiệp
东方未明=Đông Phương Vị Minh
青云十三式=Thanh Vân Thập Tam Thức
万里无云=Vạn Lý Vô Vân
林小宁=Lâm Tiểu Ninh
林宁=Lâm Ninh
青云寨=Thanh Vân trại
林大龙=Lâm Đại Long
五娘=Ngũ Nương
九娘=Cửu Nương
田二叔=Điền Nhị thúc
安郎中=An lang trung
周八叔=Chu Bát thúc
田五娘=Điền Ngũ Nương
田九娘=Điền Cửu Nương
罗南英=La Nam Anh
自白剂=thuốc sự thật
蒋奉明=Tưởng Phụng Minh
郁瑾瑜=Úc Cẩn Du
阮竹仪=Nguyễn Trúc Nghi
瑾瑜=Cẩn Du
毛少凡=Mao Thiếu Phàm
於孔目=Vu Khổng Mục
岳王=Nhạc vương
雷雨之夜=đêm dông tố
曾道友=Tằng đạo hữu
孙仲=Tôn Trọng
烈风一族=Liệt Phong nhất tộc
烈风族人=Liệt Phong tộc nhân
文安=Văn An
巫汐=Vu Tịch
青霞=Thanh Hà
赫森=Hách Sâm
赫森大长老=Hách Sâm đại trường lão
摩铎=Moduo
卡兹汗=Karshan
火鳞刀·强=Hỏa Lân Đao Cường
奴瓦=Nuwa
火鳞刀··强=Hỏa Lân Đao Cường
鞍马山=An Mã Sơn
天狗抄=Thiên Cẩu Sao
诸红尘=Chư Hồng Trần
罗老=La lão
万劫刀法=Vạn Kiếp Đao Pháp
李如壁=Lý Như Bích
司徒色望=Tư Đồ Sắc Vọng
望哥=Vọng ca
李柔=Lý Nhu
黑邪爪=Hắc Tà Trảo
谢风=Tạ Phong
柔影鞭水=Nhu Ảnh Tiên Thủy
芙蓉=Phù Dung
百兽山庄=Bách Thú sơn trang
百里宇=Bách Lý Vũ
小兽王=Tiểu Thú Vương
杜林轩=Đỗ Lâm Hiên
阿绣=A Tú
丁珰=Đinh Đang
重阳节=Trọng Dương Tiết
陈瑾=Trần Cẩn
月月=Nguyệt Nguyệt
南寄月=Nam Ký Nguyệt
酒娘=Tửu Nương
穆荷=Mục Hà
许安=Hứa An
菜州=Thái Châu
毛丰年=Mao Phong Niên
景王=Cảnh vương
李钦=Lý Khâm
阮青叶=Nguyễn Thanh Diệp
白五=Bạch Ngũ
南条建一=Nam Điều Kiến Nhất
恶使=Ác Sử
高三娘子=Cao Tam Nương Tử
白师傅=Bạch sư phụ
展飞=Triển Phi
吕正平=Lữ Chính Bình
司徒横=Tư Đồ Hoành
破天=Phá Thiên
坚弟=Kiên đệ
枯草岭=Khô Thảo Lĩnh
熊耳山=núi Hùng Nhĩ
叮叮当当=Đinh Đinh Đang Đang
侍剑=Thị Kiếm
米香主=Mễ Hương Chủ
雪山弟子=đệ tử Tuyết Sơn
气寒西北=Khí Hàn Tây Bắc
石中坚=Thạch Trung Kiên
罗汉伏魔神功=La Hán Phục Ma Thần Công
白柔柔=Bạch Nhu Nhu
白师姐=Bạch sư tỷ
叶殊=Diệp Thù
洛九嫣=Lạc Cửu Yên
殊儿=Thù nhi
百鬼门=Bách Quỷ Môn
千秋骨=Thiên Thu Cốt
雷极遁=Lôi Cực Độn
造物功=Tạo Vật Công
柔柔=Nhu Nhu
太银剑=Thái Ngân Kiếm
竹仪=Trúc Nghi
称心=Xưng Tâm
如意=Như Ý
双双=Song Song
甜甜=Điềm Điềm
盼盼=Phán Phán
樊老汉=Phàn lão hán
紫云门=Tử Vân Môn
宁月婵=Ninh Nguyệt Thiền
毛武=Mao Vũ
毛陆=Mao Lục
李锦屏=Lý Cẩm Bình
封万里=Phong Vạn Lý
成自学=Thành Tự Học
廖自砺=Liêu Tự Lệ
蓦得=Mạch Đắc
自古师娘=Tự Cổ sư nương
神倒鬼跌三连环=Thần Đảo Quỷ Điệt Tam Liên Hoàn
断肠蚀骨腐心草=Đoạn Tràng Thực Cốt Hủ Tâm Thảo
江平安=Giang Bình An
平安=Bình An
李月月=Lý Nguyệt Nguyệt
平安哥=Bình An ca
李民=Lý Dân
胡大山=Hồ Đại Sơn
方林=Phương Lâm
林龙=Lâm Long
方二叔=Phương nhị thúc
苍松院=Thương Tùng viện
小山哥=Tiểu Sơn ca
胡小山=Hồ Tiểu Sơn
方智=Phương Trí
周成=Chu Thành
周石=Chu Thạch
石头=Thạch Đầu
樊冬=Phàn Đông
礼拾=Lễ Thập
张执虎=Trương Chấp Hổ
燕折冲=Yến Chiết Trùng
师师姑娘=Sư Sư cô nương
莎雪=Toa Tuyết
东方灵月=Đông Phương Linh Nguyệt
黄龙楼=Hoàng Long lâu
黄霞=Hoàng Hà
厚土呼吸吐纳法详解=Hậu Thổ Hô Hấp Thổ Nạp Pháp Tường Giải
杨园=Dương Viên
挥刀技巧=Huy Đao Kỹ Xảo
大王山=Đại Vương Sơn
萍水县=huyện Bình Thủy
崔肖=Thôi Tiêu
血气诀=Huyết Khí Quyết
幻刀=Huyễn Đao
大河村=thôn Đại Hà
鹰叹山脉=sơn mạch Ưng Thán
上天煞峰=Thượng Thiên Sát Phong
天煞殿魔子=Thiên Sát Điện ma tử
聂青=Nhiếp Thanh
托尼马=Tony Ma
李圣杰=Lý Thánh Kiệt
顾景舟=Cố Cảnh Chu
樊二叔=Phàn nhị thúc
陈力行=Trần Lực Hành
玄骑=Huyền Kỵ
龙骧卫所=Long Tương Vệ Sở
镇抚司=Trấn Phủ Ti
龙骧卫=Long Tương Vệ
燕行烈=Yến Hành Liệt
阿五=A Ngũ
巴麻子=Ba Ma Tử
得功=Đắc Công
燕校尉=Yến giáo úy
嗯咛=Ân Ninh
师师=Sư Sư
黄司司长=Hoàng ti ti trường
黄司=Hoàng ti
石逹=Thạch Đạt
钦天监=Khâm Thiên giám
白行简=Bạch Hành Giản
罗盘商社=thương hội La Bàn
墨尾=Mặc Vĩ
凯泰=Khải Thái
红霞姐妹=Hồng Hà tỷ muội
红霞=Hồng Hà
方生=Phương Sinh
方证=Phương Chứng
麻蛋=Ma Đản
孟婉舒=Mạnh Uyển Thư
李前辈=Lý tiền bối
婉舒=Uyển Thư
李观棋=Lý Quan Kỳ
袁斌=Viên Bân
孟阔=Mạnh Khoát
连山县=huyện Liên Sơn
孟晶=Mạnh Tinh
小晶=Tiểu Tinh
千里马=Thiên Lý Mã
震刀术=Chấn Đao Thuật
厚土呼吸吐纳法=Hậu Thổ Hô Hấp Thổ Nạp Pháp
黑风郡=quận Hắc Phong
震刀=Chấn Đao
李天云=Lý Thiên Vân
叶林=Diệp Lâm
向军=Hướng Quân
天煞诀=Thiên Sát Quyết
薛涛=Tiết Đào
青棠=Thanh Đường
游手=Du Thủ
樊丹娘=Phàn Đan Nương
冷如烟=Lãnh Như Yên
程泽=Trình Trạch
青衣帮=Thanh Y bang
孟秋=Mạnh Thu
李 湷=Lý Điển
公孙嫣=Công Tôn Yên
破鞭式=Phá Tiên Thức
侯人雄=Hầu Nhân Hùng
乐厚=Nhạc Hậu
令狐国冲=Lệnh Hồ Quốc Trùng
小林子=Tiểu Lâm Tử
紫霞功=Tử Hà Công
国冲=Quốc Trùng
平之=Bình Chi
大中小尼姑=Đại Trung tiểu ni cô
队长姜震=đội trường Khương Chấn
姜震=Khương Chấn
黑沟子乡=Hắc Câu Tử hương
苏玄=Tô Huyền
萧辰=Tiêu Thần
灵台国=nước Linh Đài
夏青=Hạ Thanh
霸体决=Bá Thể Quyết
抖音=Tiktok
林海=Lâm Hải
雪玉=Tuyết Ngọc
克敌=Khắc Địch
朱蛤子=Chu Cáp Tử
单耳=Đơn Nhĩ
独眼=Độc Nhãn
张郎=Trương Lang
青妃=Thanh Phi
汉拉特=Hanrath
黑山城=thành Hắc Sơn
弥薰=Di Huân
瓦努=Vanu
张岂煊=Trương Khởi Huyên
张岭=Trương Lĩnh
垒土诀=Lũy Thổ Quyết
符文基础大全=Phù Văn Cơ Sở Đại Toàn
张灵敏=Trương Linh Mẫn
大嵩阳神掌=Đại Tung Dương Thần Chưởng
盈盈=Doanh Doanh
鹿鼎=Lộc Đỉnh
天龙=Thiên Long
顾三=Cố Tam
玉面神拳=Ngọc Diện Thần Quyền
厉上人=Lệ Thượng Nhân
杨存中=Dương Tồn Trung
李若朴=Lý Nhược Phác
尊府老翁=Tôn Phủ ông lão
礼某=Lễ mỗ
神射=Thần Xạ
叶婵怡=Diệp Thiền Di
黑风城=thành Hắc Phong
不动金钟罩=Bất Động Kim Chung Tráo
无极拳=Vô Cực Quyền
大崩拳=Đại Băng Quyền
马伟=Mã Vĩ
缥缈宗=Phiếu Miểu Tông
冯雨辰=Phùng Vũ Thần
苍穹门=Thương Khung Môn
黑虎堂=Hắc Hổ Đường
无空殿=Vô Không Điện
天王托塔式=Thiên Vương Thác Tháp Thức
铁开山=Thiết Khai Sơn
阴连城=Âm Liên Thành
万金体=Vạn Kim Thể
神凰体=Thần Hoàng Thể
阴阳心经=Âm Dương Tâm Kinh
神虚步=Thần Hư Bộ
大夏=Đại Hạ
向阳=Hướng Dương
风灵舞=Phong Linh Vũ
千柳剑术=Thiên Liễu Kiếm Thuật
庆云子=Khánh Vân Tử
魔剑山=Ma Kiếm Sơn
乌媚月=Ô Mị Nguyệt
雷闪=Lôi Thiểm
踏天靴=Đạp Thiên Ngoa
财源广进=Tài Nguyên Quảng Tiến
陈璀=Trần Thôi
张洪超=Trương Hồng Siêu
金林=Kim Lâm
闫海=Diêm Hải
王仁=Vương Nhân
樊家=Phàn gia
方星=Phương Tinh
黑炎火石=Hắc Viêm Hỏa Thạch
江道友=Giang đạo hữu
云凰=Vân Hoàng
纯阳神体=Thuần Dương Thần Thể
呼延翼=Hô Diên Dực
张斯同=Trương Tư Đồng
柳江=Liễu Giang
魏钦黎=Ngụy Khâm Lê
陆行=Lục Hành
张廷渝=Trương Đình Du
觉醒者守望公约=Giác Tỉnh Giả Thủ Vọng Công Ước
蓬萝=Bồng La
呼伦=Hô Luân
暗鸦=Ám Nha
黎三=Lê Tam
书剑恩仇录=Thư Kiếm Ân Cừu Lục
诸葛雷=Chư Cát Lôi
紫面二郎=Tử Diện Nhị Lang
秫秫=Thuật Thuật
百里安=Bách Lý An
上古神魔录 》=Thượng Cổ Thần Ma Lục 》
李酒酒=Lý Tửu Tửu
司尘=Tư Trần
离合宗=Ly Hợp Tông
求道二品=Cầu Đạo Nhị Phẩm
火莲悟道子=Hỏa Liên Ngộ Đạo Tử
沙暴葬=Sa Bạo Táng
冥尘=Minh Trần
花轻语=Hoa Khinh Ngữ
万春国=nước Vạn Xuân
斗战神术=Đấu Chiến Thần Thuật
锻神兵=Đoán Thần Binh
太阳心经=Thái Dương Tâm Kinh
王澜=Vương Lan
藏宇术=Tàng Vũ Thuật
凡尘境=Phàm Trần Cảnh
渡劫境=Độ Kiếp Cảnh
入圣境=Nhập Thánh Cảnh
求道境=Cầu Đạo Cảnh
开元境=Khai Nguyên Cảnh
拓海境=Thác Hải Cảnh
承灵境=Thừa Linh Cảnh
魂启境=Hồn Khải Cảnh
合神境=Hợp Thần Cảnh
融道境=Dung Đạo Cảnh
千劫境=Thiên Kiếp Cảnh
通瞑境=Thông Minh Cảnh
炼虚境=Luyện Hư Cảnh
古劫境=Cổ Kiếp Cảnh
不灭境=Bất Diệt Cảnh
圣人境=Thánh Nhân Cảnh
酒酒姑娘=Tửu Tửu cô nương
飞尸=Phi Thi
天钟山=Thiên Chung Sơn
柳使者=Liễu sử giả
猴儿酿=Hầu Nhi Nhưỡng
蒙双=Mông Song
柳医师=Liễu y sư
褐缕先生=Hạt Lũ tiên sinh
褐缕=Hạt Lũ
地狱猫=Địa Ngục Miêu
墨须=Mặc Tu
束身雷=Thúc Thân Lôi
破阵子=Phá Trận Tử
蛇缚=Xà Phược
炎葬=Viêm Táng
炎浪滔天=Viêm Lãng Thao Thiên
桂叔=Quế thúc
袁浩森=Viên Hạo Sâm
许敬松=Hứa Kính Tùng
南奇月=Nam Kỳ Nguyệt
南兴资=Nam Hưng Tư
任老=Nhậm lão
聋郡守=Lung quận trưởng
龚郡守=Cung quận trưởng
韩冰冰=Hàn Băng Băng
冰冰=Băng Băng
王勇=Vương Dũng
梁成伟=Lương Thành Vĩ
南岸=Nam Ngạn
蔡茂=Thái Mậu
雷布斯=Lôi Bố Tư
岑芮安=Sầm Nhuế An
岑芮静=Sầm Nhuế Tĩnh
芮安=Nhuế An
芮静=Nhuế Tĩnh
陈嫩妍=Trần Nộn Nghiên
嫩妍=Nộn Nghiên
虞子兮=Ngu Tử Hề
子兮=Tử Hề
梁郡守=Lương quận trưởng
南大小姐=Nam đại tiểu thư
虞子璎=Ngu Tử Anh
子璎=Tử Anh
虞子理=Ngu Tử Lý
爬长城=Ba Trường Thành
李诗曼=Lý Thi Mạn
诗曼=Thi Mạn
王安琪=Vương An Kỳ
贾一博=Giả Nhất Bác
嫖老师=Phiêu lão sư
陈督查=Trần đốc tra
陈震=Trần Chấn
张若若=Trương Nhược Nhược
若若=Nhược Nhược
穆奇=Mục Kỳ
圣兽宫=Thánh Thú Cung
天灵万药纲目=Thiên Linh Vạn Dược Cương Mục
灵妙宝树=Linh Diệu Bảo Thụ
穆正奇=Mục Chính Kỳ
天玺剑宗=Thiên Tỳ Kiếm Tông
婉容=Uyển Dung
曹敏=Tào Mẫn
领副指挥=Lĩnh phó chỉ huy
领副指挥使=Lĩnh phó chỉ huy sử
木提举=Mộc đề cử
大天霞炎=Đại Thiên Hà Viêm
蔷薇夫人=Tường Vi phu nhân
妙郎君=Diệu Lang Quân
花蜂=Hoa Phong
孙逵=Tôn Quỳ
伊哭=Y Khốc
青魔手=Thanh Ma Thủ
梅花盗=Mai Hoa Đạo
兴云庄=Hưng Vân Trang
锦生=Cẩm Sinh
卫国=Vệ quốc
太玄宗=Thái Huyền Tông
苍梧宫=Thương Ngô Cung
空沧山=Không Thương Sơn
万兽宫=Vạn Thú Cung
三杯气功=Tam Bôi Khí Công
倒五岳掌法=Đảo Ngũ Nhạc Chưởng Pháp
铁笛先生=Thiết Địch tiên sinh
诗音=Thi Âm
极乐峒主=Cực Lạc động chủ
神锋=Thần Phong
诸葛刚=Gia Cát Cương
寿=Thọ
尹白霜=Doãn Bạch Sương
白霜=Bạch Sương
大卫国=Đại Vệ quốc
苍梧=Thương Ngô
程盘=Trình Bàn
尹姑娘=Doãn cô nương
北燎镇=Bắc Liệu trấn
泥儿酒=Nê Nhi tửu
齐扬=Tề Dương
温玉=Ôn Ngọc
西方太玄=Tây Phương Thái Huyền
七烬步=Thất Tẫn Bộ
太玄=Thái Huyền
焚河剑诀=Phần Hà Kiếm Quyết
焚河=Phần Hà
陈小兰=Trần Tiểu Lan
小白花=hoa trắng nhỏ
陈豹=Trần Báo
林归垣=Lâm Quy Viên
玄之=Huyền Chi
文贞冬=Văn Trinh Đông
归垣=Quy Viên
南泽山=núi Nam Trạch
黄康=Hoàng Khang
观魔堂=Quan Ma Đường
幽皇朝=U Hoàng Triều
白虎符=Bạch Hổ Phù
温康=Ôn Khang
阴虎符=Âm Hổ Phù
英灵鬼虎=Anh Linh Quỷ Hổ
阴虎大人=Âm Hổ đại nhân
天玺=Thiên Tỳ
鸢戾大人=Diên Lệ đại nhân
鸢戾=Diên Lệ
秋水剑=Thu Thủy kiếm
千阕宗=Thiên Khuyết tông
无尽之海=Vô Tận Hải
凌虚剑法=Lăng Hư Kiếm Pháp
风烈=Phong Liệt
听风烈说=nghe Phong Liệt nói
司离=Tư Ly
夏淳罡=Hạ Thuần Cương
赵白洵=Triệu Bạch Tuân
张丹心=Trương Đan Tâm
与天玺=cùng Thiên Tỳ
魔界六河=Ma Giới Lục Hà
与天玺十三剑=Dữ Thiên Tỳ Thập Tam Kiếm
太玄九经=Thái Huyền Cửu Kinh
六河=Lục Hà
酒酒=Tửu Tửu
剑血大阵=Kiếm Huyết đại trận
离合=Ly Hợp
九原山鬼门=Cửu Nguyên Sơn Quỷ Môn
九原山=Cửu Nguyên Sơn
张艾博=Trương Ngải Bác
姜, 姜育东=Khương, Khương Dục Đông
雷青云=Lôi Thanh Vân
神虚道人=Thần Hư Đạo Nhân
朱鱼果=quả Chu Ngư
十三剑大人=Thập Tam Kiếm đại nhân
罹灾降=Ly Tai Hàng
寇都头=Khấu đô đầu
王唤=Vương Hoán
左仆射=Tả Phó Xạ
安黛兮=An Đại Hề
如烟=Như Yên
陈生=Trần Sinh
程属官=Trình thuộc quan
朱煜=Chu Dục
虎字营=Hổ Tự doanh
夏天禄=Hạ Thiên Lộc
孟江初=Mạnh Giang Sơ
嬴姬=Doanh Cơ
窫 窳=Ấp Dũ
萧鸣=Tiêu Minh
昭河=Chiêu Hà
凡胎之境=cảnh giới Phàm Thai
德火经=Đức Hỏa Kinh
尹小姑娘=Doãn tiểu cô nương
弃人=Khí Nhân
永无止境=cảnh giới Vĩnh Vô
千万束=ngàn vạn tia
洗雪剑=Tẩy Tuyết kiếm
云容=Vân Dung
影尸=Ảnh Thi
绝尸=Tuyệt Thi
尸祖=Thi Tổ
尸神=Thi Thần
萧铭=Tiêu Minh
苏靖=Tô Tĩnh
越女=Việt Nữ
君河=Quân Hà
狂草剑=Cuồng Thảo kiếm
拓海=Thác Hải
广梦城=thành Quảng Mộng
商莹=Thương Oánh
十藏殿=Thập Tàng Điện
天曜史典=Thiên Diệu Sử Điển
鹿鹿=Lộc Lộc
平冶城=thành Bình Dã
小东子=Tiểu Đông tử
道身=Đạo Thân
孙攀=Tôn Phàn
苑儿=Uyển nhi
阴阳道鱼=Âm Dương đạo ngư
云容姐姐=Vân Dung tỷ tỷ
天玺第四剑=Thiên Tỳ Đệ Tứ Kiếm
十方城=thành Thập Phương
方歌渔=Phương Ca Ngư
歌渔=Ca Ngư
梵阴剑=Phạm Âm kiếm
梵阴剑经=Phạm Âm kiếm kinh
张红艳=Trương Hồng Diễm
陆家骡马行=Lục Gia Loa Mã Hành
狗爷=Cẩu gia
小承庆=tiểu Thừa Khánh
承庆=Thừa Khánh
陆亚=Lục Á
鸭哥=Áp Ca
翻海剑诀=Phiên Hải Kiếm Quyết
叠浪枪术=Điệp Lãng Thương Thuật
十方道门=Thập Phương Đạo Môn
龙腾凰鸣决=Long Đằng Hoàng Minh Quyết
奇门秘术=Kỳ Môn Bí Thuật
千焰决=Thiên Diễm Quyết
朝元聚气经 》=Triều Nguyên Tụ Khí Kinh 》
海纳吐息决=Hải Nạp Thổ Tức Quyết
傅九郎=Phó Cửu Lang
王城=Vương Thành
朱宸=Chu Thần
张子良=Trương Tử Lương
杜如寒=Đỗ Như Hàn
福迅=Phúc Tấn
时代舰船=Thuyền Thời Đại
落星使=Lạc Tinh Sử
李凌星=Lý Lăng Tinh
金罗=Kim La
红莲天舞=Hồng Liên Thiên Vũ
十殿阎罗=Thập Điện Diêm La
合体=Hợp Thể
天歌城=thành Thiên Ca
金光寺=chùa Kim Quang
怀悲大师=Hoài Bi đại sư
林憨憨=Lâm ngu ngơ
临西泽=Lâm Tây Trạch
临西泽之国=nước Lâm Tây Trạch
西合城=thành Tây Hợp
迦偌寺=chùa Già Nhạ
叶帘=Diệp Liêm
迦臣=Già Thần
石广=Thạch Quảng
胡大宗主=Hồ đại tông chủ
万寿观=Vạn Thọ Quan
萧旧师=Tiêu Cựu Sư
刘提=Lưu Đề
刘莫=Lưu Mạc
王庆海=Vương Khánh Hải
王庆国=Vương Khánh Quốc
太阳神教=Thái Dương Thần Giáo
天泽圣地=thánh địa Thiên Trạch
太阴神教=Thái Âm thần giáo
财源商会=Tài Nguyên Thương Hội
海纳吐息诀=Hải Nạp Thổ Tức Quyết
成梁=Thành Lương
白莲左使=Bạch Liên tả sử
总旗=Tổng Kỳ
九郎=Cửu Lang
郑化=Trịnh Hóa
徐康之=Từ Khang Chi
海默=Hải Mặc
杨希夷=Dương Hi Di
凯泰王国=vương quốc Khải Thái
派克斯=Parker
锁天山庄=Tỏa Thiên sơn trang
天兵楼=Thiên Binh lâu
九天门=Cửu Thiên môn
胡玲=Hồ Linh
刘大春=Lưu Đại Xuân
南华真经=Nam Hoa Chân Kinh
蒋柱=Tưởng Trụ
李一刀=Lý Nhất Đao
南兵阁=Nam Binh Các
神府南境=Thần Phủ nam Cảnh
清寒山=núi Thanh Hàn
方歌=Phương Ca
徐向=Từ Hướng
梁言=Lương Ngôn
宇文天=Vũ Văn Thiên
燃血蛊=Nhiên Huyết Cổ
提线仙=Đề Tuyến Tiên
入细初阶=Nhập Tế Sơ Giai
入细=Nhập Tế
入细中阶=Nhập Tế Trung Giai
平冶=Bình Dã
文安公主=Văn An công chúa
七里巷=hẻm Thất Lý
杨上校=Dương thượng tá
亥伯龙=Hyperion Long
科帝克巨魔=Khoa Đế Khắc Cự Ma
科帝克=Khoa Đế Khắc
魏安=Ngụy An
左千言=Tả Thiên Ngôn
李探花=Lý Tham Hoa
嵩阳铁剑=Tung Dương Thiết Kiếm
铃铃=Linh Linh
怜花宝鉴=Liên Hoa Bảo Giám
玉叶=Ngọc Diệp
清尘堂=Thanh Trần Đường
玉叶姑娘=Ngọc Diệp cô nương
妙明寺=chùa Diệu Minh
师成=Sư Thành
那克敌弓=Na Khắc Địch cung
赵瑗=Triệu Viện
大璫张=Đại Đang Trương
赵密=Triệu Mật
夏群=Hạ Quần
夏元昊=Hạ Nguyên Hạo
孟子非=Mạnh Tử Phi
孟仙人=Mạnh tiên nhân
梅露洛=Mai Lộ Lạc
灵能者荣誉决斗公约=Linh Năng Giả Vinh Dự Quyết Đấu Công Ước
水蛇胡媚=Thủy Xà Hồ Mị
杨承祖=Dương Thừa Tổ
向松=Hướng Tùng
红花当杀=Hồng Hoa Đương Sát
独孤剑南=Độc Cô Kiếm Nam
千面郎君=Thiên Diện Lang Quân
风雨双流星=Phong Vũ Song Lưu Tinh
千里不留行=Thiên Lý Bất Lưu Hành
十步杀一人=Thập Bộ Sát Nhất Nhân
十步一杀=Thập Bộ Nhất Sát
生生不息=Sinh Sinh Bất Tức
李州=Lý châu
雪承=Tuyết Thừa
千机杵=Thiên Cơ Xử
阿靖=a Tĩnh
柳居士=Liễu cư sĩ
觉醒者保护法=Giác Tỉnh Giả Bảo Hộ Pháp
柴门上校=Sài Môn thượng tá
拉帕什=Rapas
沙鲁克=Charouk
余潇=Dư Tiêu
刘绮罗=Lưu Khỉ La
新巴黎=Tân Paris
李桂兰=Lý Quế Lan
龙候=Long Hậu
蓝花退守=Lam Hoa Thối Thủ
梁道友=Lương đạo hữu
流水拳=Lưu Thủy Quyền
太阳神轮=Thái Dương Thần Luân
宋慧=Tống Tuệ
无尽山脉=Vô Tận sơn mạch
陆成风=Lục Thành Phong
尉迟游=Úy Trì Du
问谷山=Vấn Cốc Sơn
万醒丹=Vạn Tỉnh Đan
尉迟公子=Úy Trì công tử
太玄生莲=Thái Huyền Sinh Liên
找酒酒=tìm Tửu Tửu
隍陈敬道=Hoàng Trần Kính Đạo
韩知=Hàn Tri
李魁奇=Lý Khôi Kỳ
韩知微=Hàn Tri Vi
大傩=Đại Na
李湷=Lý Điển
多纳德=Donard
伊雯雅=Y Văn Nhã
谷庸=Cốc Dung
曹彦=Tào Ngạn
道剑经=Đạo Kiếm Kinh
养剑篇=Dưỡng Kiếm Thiên
天阴=Thiên Âm
辛九=Tân Cửu
五毒神=Ngũ Độc Thần
巫行空=Vu Hành Không
小月=tiểu Nguyệt
雷宇=Lôi Vũ
朱康=Chu Khang
金星城=thành Kim Tinh
酒城=Tửu thành
承灵之境=Thừa Linh cảnh
飞云山=núi Phi Vân
温含薇=Ôn Hàm Vi
含薇=Hàm Vi
御霄剑=Ngự Tiêu Kiếm
惊围阵=Kinh Vi Trận
承灵大境=Thừa Linh đại cảnh
老赤眼=lão mắt đỏ
那尼=Nani
朱廉=Chu Liêm
灵光城=thành Linh Quang
冥王州=Minh Vương Châu
卜司=Bặc Tư
觉醒丹=Giác Tỉnh Đan
牛战峰=Ngưu Chiến Phong
温... 姐姐=Ôn... Tỷ tỷ
苏观海=Tô Quan Hải
太玄功法=Thái Huyền Công Pháp
温. . . 姐姐=Ôn. . . Tỷ Tỷ
在飞云山=ở núi Phi Vân
乱幽谷=Loạn u cốc
器峰=Khí Phong
恶影兽=Ác Ảnh Thú
祝斩=Chúc Trảm
黑暗之城=thành Hắc Ám
江小友=Giang tiểu hữu
周全仁=Chu Toàn Nhân
冯澜=Phùng Lan
楚禅=Sở Thiền
天策录=Thiên Sách Lục
鹅城=Nga thành
了难=Liễu Nan
了凡=Liễu Phàm
曹伟毅=Tào Vĩ Nghị
曹振南=Tào Chấn Nam
尼希塔=Nichita
查伦王子=Tra Luân vương tử
查伦=Tra Luân
七绝堂=Thất Tuyệt đường
白发魔女传=Bạch Phát Ma Nữ Truyện
白发魔女=Bạch Phát Ma Nữ
江流风=Giang Lưu Phong
云澜=Vân Lan
张易天=Trương Dịch Thiên
七邪绝爪=Thất Tà Tuyệt Trảo
七邪血爪=Thất Tà Huyết Trảo
燃血秘法=Nhiên Huyết Bí Pháp
流云=Lưu Vân
邹绛霞=Trâu Giáng Hà
奉怀小县=huyện Phụng Hoài nhỏ
裴液=Bùi Dịch
大耳朵=Đại Nhĩ Đóa
陆有材=Lục Hữu Tài
奉怀=Phụng Hoài
越爷爷=Việt gia gia
神眷=Thần Quyến
仙君唤=Tiên Quân Hoán
仙君唤灵=Tiên Quân Hoán Linh
鹑首=Thuần Thủ
雨街=Vũ Nhai
常致远=Thường Trí Viễn
林霖=Lâm Lâm
仙人台=Tiên Nhân Đài
沈闫平=Thẩm Diêm Bình
林珏=Lâm Giác
冯志=Phùng Chí
胡烨=Hồ Diệp
虞风·灵有所好=Ngu Phong · Linh Hữu Sở Hảo
三朝诗笺=Tam Triều Thi Tiên
烛世教=Chúc Thế giáo
荆都尉=Kinh đô úy
小云山=núi Tiểu Vân
揉云=Nhu Vân
祝高阳=Chúc Cao Dương
楚书江=Sở Thư Giang
楚厚照=Sở Hậu Chiếu
楚战=Sở Chiến
栗小松=Lật Tiểu Tùng
张大虎=Trương Đại Hổ
徐定=Từ Định
王龙=Vương Long
娄成=Lâu Thành
报国寺=Báo Quốc Tự
百岁宫=Bách Tuế Cung
冥川=Minh Xuyên
蒋廷=Tưởng Đình
贺立=Hạ Lập
嗣空=Tự Không
幸无=Hạnh Vô
昭和国=Chiêu Hòa Quốc
缥缈城=thành Phiếu Miểu
江山图=Giang Sơn Đồ
噬血九幽虫=Phệ Huyết Cửu U trùng
庆小少爷=Khánh tiểu thiếu gia
王子服=Vương Tử Phục
云水散人=Vân Thủy Tán Nhân
王乔=Vương Kiều
郝浩=Hách Hạo
郝浩昌=Hách Hạo Xương
藏灵上人=Tàng Linh Thượng Nhân
|=
毒 | 龙针=Độc Long Châm
方邪帝=Phương Tà Đế
钟展=Chung Triển
程风=Trình Phong
鹤凫册=sách Hạc Phù
秀秀=Tú Tú
禀禄=Bẩm Lộc
灵明照世浮尘无拘=Linh Minh Chiếu Thế Phù Trần Vô Câu
商浪=Thương Lãng
邢栀=Hình Chi
红莲舞=Hồng Liên Vũ
莎伦·白腕=Sharon Bạch Oản
奥森·黑鳍=Orson Hắc Kỳ
展悦=Triển Duyệt
顾成蹊=Cố Thành Hề
万灵界=Vạn Linh Giới
东国=Đông Quốc
血月魔君=Huyết Nguyệt Ma Quân
芈红尘=Mị Hồng Trần
旭日城=thành Húc Nhật
阿月=A Nguyệt
通明塔=Thông Minh Tháp
旭日商会=thương hội Húc Nhật
血喉=Huyết Hầu
阿攀=A Phàn
通明神女=Thông Minh Thần Nữ
通明石=Thông Minh Thạch
通明女神像=tượng Thông Minh Nữ Thần
天下书馆=Thiên Hạ Thư Quán
夜魇=Dạ Yểm
曦轩=Hi Hiên
玉山盟=Ngọc Sơn Minh
程露=Trình Lộ
太阳骑士团=Thái Dương Kỵ Sĩ Đoàn
朝阳国=Triều Dương Quốc
金狮子凯恩=Kim Sư Tử Khải Ân
熊心=Hùng Tâm
苏安=Tô An
龙象大力真经=Long Tượng Đại Lực Chân Kinh
苍州=Thương Châu
施念姑=Thi Niệm Cô
李紫霜=Lý Tử Sương
唐诗云=Đường Thi Vân
书君=Thư Quân
肖黑=Tiêu Hắc
肖黑子=Tiêu Hắc Tử
小离=Tiểu Ly
照阳诀=Chiếu Dương Quyết
化雪归=Hóa Tuyết Quy
羽公子=Vũ công tử
渡劫第四境=Độ Kiếp Đệ Tứ Cảnh
不过渡劫一境=không quá Độ Kiếp Nhất Cảnh
渡劫一境=Độ Kiếp Nhất Cảnh
大昭国=nước Đại Chiêu
神封=Thần Phong
换死符=Hoán Tử Phù
替死符=Thế Tử Phù
同命符=Đồng Mệnh Phù
江平=Giang Bình
腾远=Đằng Viễn
幻影身法=Huyễn Ảnh Thân Pháp
杀戮塔=Sát Lục Tháp
蓝彩蝶=Lam Thải Điệp
杨之极=Dương Chi Cực
东天王=Đông Thiên Vương
西天王=Tây Thiên Vương
陆玄=Lục Huyền
百鬼摘要=Bách Quỷ Trích Yếu
溺童妇=Nịch Đồng Phụ
金狮子瑞恩=Kim Sư Tử Ryan
展云飞=Triển Vân Phi
黎夕=Lê Tịch
在旭日城=tại thành Húc Nhật
『 西 』 提醒您: 合理安排阅读时间, 杜绝沉迷网络小说=
东直门=cổng Đông Trực
张小菲=Trương Tiểu Phi
网红孵化公司=công ty Võng Hồng Phu Hóa
禹哲=Vũ Triết
俞峰=Du Phong
张晓萍=Trương Hiểu Bình
李琦=Lý Kỳ
俞总=Du tổng
安衾=An Khâm
肖汉=Tiêu Hán
夏安衾=Hạ An Khâm
帝梦瑶=Đế Mộng Dao
黑鳍=Hắc Kỳ
猩鬃=Tinh Tông
翼仲牟=Dực Trọng Mưu
金关玉骨诀=Kim Quan Ngọc Cốt Quyết
崔玉=Thôi Ngọc
赶尸门=Cản Thi Môn
易容术=Dịch Dung Thuật
天斧门=Thiên Phủ Môn
黑虎谷=Hắc Hổ Cốc
宁莜=Ninh Du
妖狱山=Yêu Ngục Sơn
骨耶魔蝶=Cốt Da Ma Điệp
天玺十三剑=Thiên Tỳ Thập Tam Kiếm
七经之主=Thất Kinh Chi Chủ
八经之主=Bát Kinh Chi Chủ
朱栏门外=ngoài Chu Lan Môn
将酒酒=đem Tửu Tửu
空沧山境=Không Thương sơn cảnh
仙陵城=thành Tiên Lăng
君皇娘娘=Quân Hoàng nương nương
隔空沧山=cách Không Thương Sơn
柴烨=Sài Diệp
明元基=Minh Nguyên Cơ
安思琪=An Tư Kỳ
黎悲风=Lê Bi Phong
小绿瓜=Tiểu Lục Qua
尹小姐=Doãn tiểu thư
玄风令=Huyền Phong lệnh
古法山=Cổ Pháp Sơn
蓝幼蝶=Lam Ấu Điệp
歌儿小姐=Ca Nhi tiểu thư
歌儿=Ca Nhi
温经主=Ôn kinh chủ
太白丹=Thái Bạch Đan
古灵宝丹=Cổ Linh Bảo Đan
七宝灵丹=Thất Bảo Linh Đan
白玉云丹=Bạch Ngọc Vân Đan
万道仙盟=Vạn Đạo Tiên Minh
临泉=Lâm Tuyền
羽河=Vũ Hà
天海山楼=Thiên Hải Sơn Lâu
与天海山楼=cùng Thiên Hải Sơn Lâu
周儒言=Chu Nho Ngôn
照亭街=đường Chiếu Đình
季盈=Quý Doanh
季亭=Quý Đình
丝方尽=Ti Phương Tận
轻水=Khinh Thủy
东贯小镇=Đông Quán tiểu trấn
第四剑=Đệ Tứ Kiếm
摧天·诛仙=Tồi Thiên · Tru Tiên
南宫曦=Nam Cung Hi
杜沅=Đỗ Nguyên
鲁柯=Lỗ Kha
终南天=Chung Nam Thiên
跨域=Khóa Vực
观棋=Quan Kỳ
涂长老=Đồ trường lão
陆康年=Lục Khang Niên
李南廷=Lý Nam Đình
叶青儿=Diệp Thanh Nhi
凌墟大陆=Lăng Khư Đại Lục
叶天英=Diệp Thiên Anh
苏溪=Tô Khê
青云大陆=Thanh Vân Đại Lục
沈烨=Thẩm Diệp
段杨=Đoạn Dương
摒息术=Bính Tức Thuật
竹院=Trúc Viện
杨朝明=Dương Triều Minh
胡蕴=Hồ Uẩn
剑雨术=Kiếm Vũ Thuật
胡鸿天=Hồ Hồng Thiên
闫晨星=Diêm Thần Tinh
梁肖宏=Lương Tiêu Hoành
梁熙=Lương Hi
吞天鳄族=Thôn Thiên Ngạc tộc
康瑞=Khang Thụy
风雅集=Phong Nhã Tập
四剑姑娘=Tứ Kiếm cô nương
日玄境巅峰=Nhật Huyền Cảnh Đỉnh Phong
注灵法=Chú Linh Pháp
正玄九阶=Chính Huyền Cửu Giai
狂魔血喉=Cuồng Ma Huyết Hầu
孟承之=Mạnh Thừa Chi
白木学府=Bạch Mộc Học Phủ
四大荒宅=Tứ Đại Hoang Trạch
山, 林, 幽, 火=Sơn, Lâm, U, Hỏa
求道=Cầu Đạo
承灵=Thừa Linh
风雪集=Phong Tuyết Tập
戮天海=Lục Thiên Hải
康弘=Khang Hoằng
康岩山=Khang Nham Sơn
琉璃=Lưu Ly
知夏=Tri Hạ
菲娜·李=Fina Lý
菲菲=Phi Phi
菲娜=Fina
龙曲=Long Khúc
北天王龙曲=Bắc Thiên Vương Long Khúc
百里兄=Bách Lý huynh
嬴袖=Doanh Tụ
陶子嫣=Đào Tử Yên
夏海明=Hạ Hải Minh
季三儿=Quý tam nhi
诏国=Chiếu quốc
百里谷=Bách Lý Cốc
仙仙=Tiên Tiên
赐名为翩翩=tên là Phiên Phiên
百里翩翩=Bách Lý Phiên Phiên
夏东明=Hạ Đông Minh
落日古堡=Lạc Nhật Cổ Bảo
落日荒原=Lạc Nhật Hoang Nguyên
九霄=Cửu Tiêu
赤雷狻猊=Xích Lôi Toan Nghê
大虞=Đại Ngu
Your sister=Your sister
地, 水, 火, 风=Địa, Thủy, Hỏa, Phong
风, 火, 水, 地=Phong, Hỏa, Thủy, Địa
万象森林的地脉守护者=Vạn Tượng Sâm Lâm Địa Mạch Thủ Hộ Giả
两千七百五十三万四千=27,534,000
素, 法, 时, 空=Tố, Pháp, Thời, Không
天, 阿修罗, 人间=Thiên, A Tu La, Nhân Gian
唯知唯识, 唯海如命=Duy Tri Duy Thức, Duy Hải Như Mạng
1883452166=1883452166
太上感应临斗诛邪大阵=Thái Thượng Cảm Ứng Lâm Đấu Tru Tà Đại Trận
二十六种技击一拳就会=Hai Mươi Sáu Loại Quyền Thuật Một Quyền Liền Biết
天之将倾, 其黑尤烈=Thiên Chi Tướng Khuynh, Kỳ Hắc Vưu Liệt
太上感应, 天官赐灵=Thái Thượng Cảm Ứng, Thiên Quan Tứ Linh
阿修罗永战纪元之城=A Tu La Vĩnh Chiến Kỷ Nguyên Thành
十九万九千九百九十=199 990
死亡的灵肉剥离之术=Tử Vong Linh Nhục Bác Ly Chi Thuật
非融合式世界链接器=Phi Dung Hợp Thức Thế Giới Kết Nối Khí
第四千七百三十五号=thứ 4773
第八千九百九十九号=thứ 8999
一万九千九百九十九=19 999
第 67731 号=số thứ 67731
超远距离神经元映射=Siêu Viễn Cự Ly Thần Kinh Nguyên Ánh Xạ
序列之敌的永恒凝固=Ngưng Kết Vĩnh Hằng Kẻ Địch Danh Sách
xiāng xia=xiāng xia
92025型机器人=người máy loại 92025
por max 版=bản PRO MAX
姹女迷情魔心大法=Xá Nữ Mê Tình Ma Tâm Đại Pháp
灰暗的神尸啃噬者=Hôi Ám Thần Thi Khẳng Phệ Giả
风元素的追逐之击=Phong Nguyên Tố Truy Trục Chi Kích
众生命运的审判者=Chúng Sinh Vận Mệnh Người Thẩm Phán
万界拘魂锁命大阵=Vạn Giới Câu Hồn Tỏa Mệnh Đại Trận
世界无限淘汰之握=Thế Giới Vô Hạn Đào Thải Ác
极古剑术, 无因=Cực Cổ Kiếm Thuật, Vô Nhân
放. . . 逐=Trục. . . Xuất
终末之祭的传承人=Chung Mạt Tế Người Truyền Thừa
天下无不散之筵席=Thiên hạ không có bữa tiệc nào không tàn
咕. . . 咕=Ục. . . Ục
05322579=05322579
四圣柱之地, 水=Tứ Thánh Trụ Địa, Thủy
0371 号界碑=cột mốc biên giới số 0371
无尽死亡的指引者=Kẻ Chỉ Dẫn Vô Tận Tử Vong
无用者的临时监狱=Ngục Giam Tạm Thời Của Kẻ Vô Dụng
10275型人形=loại 10275 hình người
S11-4798=S11-4798
第 1666 号=số hiệu 1666
秘. . . 密=Bí. . . Mật
天人合一的极境=Thiên Nhân Hợp Nhất Cực Cảnh
基因众生谱之战=Gien Chúng Sinh Phổ Chi Chiến
死亡之神的低语=Lời Nói Thì Thầm Của Tử Vong Chi Thần
乱劫之风的礼赞=Loạn Kiếp Chi Phong Lễ Tán
命运的决定之言=Vận Mệnh Quyết Định Lời Nói
众生守护者之盾=Chúng Sinh Thủ Hộ Giả Thuẫn
功德业火净莲华=Công Đức Nghiệp Hỏa Tịnh Liên Hoa
天与地的持有者=Thiên Và Địa Người Nắm Giữ
Servant=Servant
命运痕迹之果实=Vận Mệnh Vết Tích Quả
'百斩' 之术='Bách Trảm' Thuật
圣言术 · 净=Thánh Ngôn Thuật · Tịnh
圣言术 · 戒=Thánh Ngôn Thuật · Giới
六道的遗忘之术=Lục Đạo Lãng Quên Thuật
命运的终结之刃=Vận Mệnh Kết Thúc Đao
神秘的死亡之龙=Thần Bí Tử Vong Long
诸界毁灭者游戏=Chư Giới Hủy Diệt Giả Trò Chơi
百千万神皇霸主=Bách Thiên Vạn Thần Hoàng Bá Chủ
地, 水, 风=Địa, Thủy, Phong
圣柱之地, 水=Thánh Trụ Địa, Thủy
万仙九转弑灵阵=Vạn Tiên Cửu Chuyển Thí Linh Trận
过去沉睡的纪元=quá khứ ngủ say kỷ nguyên
命运分别之影术=Vận Mệnh Phân Biệt Hình Bóng Thuật
八百神翼天圣者=Bát Bách Thần Dực Thiên Thánh Giả
九转还魂造化丹=Cửu Chuyển Hoàn Hồn Tạo Hóa Đan
S9005 号=số hiệu S9005
03687 号=số 03687
生物波动抑制器=máy ức chế ba động sinh vật
0371 界碑=cột mốc biên giới 0371
S0005 号=hiệu S0005
一个月的第一天=ngày đầu tiên của tháng
能量守恒置换器=Năng Lượng Bảo Toàn Chuyển Hóa Khí
夜神的虚无之衣=Dạ Thần Hư Vô Y
折磨与痛苦之鞭=Tra Tấn Và Thống Khổ Chi Tiên
进食后的失魂者=Kẻ Mất Hồn Sau Khi Ăn
祭魂的因果丧钟=Tế Hồn Nhân Quả Chuông Tang
失落的骑士之书=Quyển Sách Kỵ Sĩ Bị Thất Lạc
临风有意问月来=Lâm Phong Hữu Ý Vấn Nguyệt Lai
踏雪无痕寻梅去=Đạp Tuyết Vô Ngân Tầm Mai Khứ
君埋泉下泥销骨=Quân Dưới Suối Vàng, Xương Hoá Bùn Đất
我寄人间雪满头=Ta Tại Nhân Gian Tuyết Trắng Đầu
米克特提卡希瓦=Mikt Tikashiva
por max=PRO MAX
皇极霸道之眼=Hoàng Cực Phách Đạo Nhãn
天界轮转玉碟=Thiên Giới Luân Chuyển Đĩa Ngọc 
六足双翼化蛇=Lục Túc Song Dực Hóa Xà
众生同调奥秘=Chúng Sinh Đồng Điều Áo Bí
极古战争之墙=Cực Cổ Chiến Tranh Tường
诸界末日在线=Chư Giới Tận Thế Online
光影记录之镜=Quang Ảnh Ký Lục Kính
时代重影之术=Thời Đại Bóng Chồng Thuật
万物扭曲之主=Vạn Vật Nữu Khúc Chủ
扭曲万物之主=Nữu Khúc Vạn Vật Chủ
冰幽灭情神泉=Băng U Diệt Tình Thần Tuyền
美杜莎的凝视=Medusa Ngưng Thị
冰肌玉骨战体=Băng Cơ Ngọc Cốt Chiến Thể
众生祭命之舞=Chúng Sinh Tế Mệnh Vũ
乱五行轰击盘=Loạn Ngũ Hành Oanh Kích Bàn
万物同调奥秘=Vạn Vật Đồng Điều Áo Bí
火焰元素巨人=Hỏa Diễm Nguyên Tố Cự Nhân
永葆青春之泉=Vĩnh Bảo Thanh Xuân Tuyền
命运预见之书=Vận Mệnh Dự Kiến Chi Thư
无穷世界之瞳=Vô Cùng Thế Giới Chi Đồng
南 10 字=Nam Thập Tự
死亡荒野世界=Tử Vong Hoang Dã Thế Giới
冰霜沉眠之龙=Băng Sương Trầm Miên Chi Long
元素精灵之王=Nguyên Tố Tinh Linh Vương
老老老老老大=Lão Lão Lão Lão Lão Đại
时光回溯之术=Thời Gian Hồi Tưởng Chi Thuật
平行虚梦之术=Bình Hành Hư Mộng Chi Thuật
天地无痕之剑=Thiên Địa Vô Ngân Chi Kiếm
镇狱鬼王之缚=Trấn Ngục Quỷ Vương Chi Phược
人面腾爪恶鬼=Nhân Diện Đằng Trảo Ác Quỷ
生死轮转之术=Sinh Tử Luân Chuyển Thuật
万首镇压之阵=Vạn Thủ Trấn Áp Trận
毗摩智多罗王=Bì Ma Trí Đa La Vương
万魔蚀魂虫咒=Vạn Ma Thực Hồn Trùng Chú
万魔蚀魂虫蛊=Vạn Ma Thực Hồn Trùng Cổ
三十三天灵感=Tam Thập Tam Thiên Linh Cảm
大地巨魔双猿=Đại Địa Cự Ma Song Viên
先天不败神功=Tiên Thiên Bất Bại Thần Công
冰霜独角魔牛=Băng Sương Độc Giác Ma Ngưu
灵魂陨落之弓=Linh Hồn Vẫn Lạc Cung
诸界回转之祭=Chư Giới Hồi Chuyển Tế
诸界回生之祭=Chư Giới Hồi Sinh Tế
九幽阴咒玉牌=Cửu U Âm Chú Ngọc Bài
幽暗虚空之母=U Ám Hư Không Mẫu
九重太乙剑阵=Cửu Trọng Thái Ất Kiếm Trận
虚空风暴之洞=Hư Không Phong Bạo Hang Động
ZuODon=Zuodon
命运惩戒之钟=Vận Mệnh Trừng Giới Chung
灵魂凋零之弓=Linh Hồn Điêu Linh Cung
死亡绽放之弓=Tử Vong Nở Rộ Cung
断罪天使之翼=Đoạn Tội Thiên Sứ Cánh
圣言术: 净=Thánh Ngôn Thuật: Tịnh
天与地的主人=Chủ Nhân Thiên Và Địa
瑶光倾落之术=Dao Quang Khuynh Lạc Thuật
扶摇冲宵之术=Phù Diêu Trùng Tiêu Thuật
秘密呼唤之杖=Bí Mật Hô Hoán Trượng
无穷源力之主=Vô Tận Nguyên Lực Chi Chủ
必亡预兆之线=Dây Báo Hiệu Phải Chết
永恒源力之王=Vĩnh Hằng Nguyên Lực Chi Vương
世界之力的人=Thế Giới Chi Lực người
末日: 司命=Tận Thế: Tư Mệnh
命运终止之甲=Vận Mệnh Kết Thúc Giáp
万神应允之匙=Vạn Thần Đáp Ứng Chìa Khóa
死亡星辰之盾=Tử Vong Tinh Thần Thuẫn
不可知的末日=Không Có Biết Tận Thế
末日同调奥秘=Tận Thế Đồng Điều Áo Bí
超微缩幺米级=Cấp 1 Siêu Vi Co
神魂侵蚀之术=Thần Hồn Xâm Thực Thuật
永恒击打之拳=Vĩnh Hằng Kích Đả Quyền
大德圣威天尊=Đại Đức Thánh Uy Thiên Tôn
末日共性奥秘=Tận Thế Cộng Tính Áo Bí
神鬼莫测之境=Thần Quỷ Khó Lường Cảnh
戮魔九转仙阵=Lục Ma Cửu Chuyển Tiên Trận
顾, 顾青山=Cố, Cố Thanh Sơn
百分之三点五=3.5%
心灵视野之镜=Tâm Linh Tầm Nhìn Kính
永恒深渊之底=đáy Vĩnh Hằng Vực Sâu
村守 · 五=Thôn Thủ · Ngũ
六道契约焚神=Lục Đạo Khế Ước Đốt Thần
第九千一百号=số hiệu thứ 9100
圣界的眷顾者=Thánh Giới Người Chiếu Cố
一人万生之术=Nhất Nhân Vạn Sinh Thuật
点金成铁之术=Điểm Kim Thành Thiết Thuật
死亡传承之器=tử vong truyền thừa binh khí
虚无静谧神衣=Hư Vô Tĩnh Mịch Thần Y
终极奥秘之术=Chung Cực Huyền Bí Thuật
幽影夜鬼之爪=U Ảnh Dạ Quỷ Trảo
灭绝灾厄之龙=Diệt Tuyệt Tai Ách Long
六小时十一分=sáu tiếng mười một phút
四小时十二分=bốn giờ mười hai phút
沙... 沙=Sa... Sa
万神泯灭之阵=Vạn Thần Mẫn Diệt Trận
万古逆乱之地=Vạn Cổ Nghịch Loạn Địa
四面魔王之相=Tứ Diện Ma Vương tướng
万灵蒙昧之术=Vạn Linh Mông Muội Thuật
万灵蒙蔽之术=Vạn Linh Che Đậy Thuật
恒云剑宗三剑=Hằng Vân Kiếm Tông Tam Kiếm
滴滴滴滴滴滴=Tích Tích Tích Tích Tích Tích
黑暗大妖龙王=Hắc Ám Đại Yêu Long Vương
命运侵蚀之术=Vận Mệnh Ăn Mòn Thuật
众灵蒙昧之术=Chúng Linh Mông Muội Thuật
孤鸿飞仙之术=Cô Hồng Phi Tiên Thuật
黑暗冰霜之猪=Hắc Ám Băng Sương Heo
身份申请程序=chương trình đăng ký xin thân phận
灵魂渡界之花=Linh Hồn Độ Giới Hoa
末... 日=Tận... Thế
力量蓄积之环=Lực Lượng Súc Tích Vòng
平行世界之术=Thế Giới Song Song Thuật
太上感应临斗=Thái Thượng Cảm Ứng Lâm Đấu
洪荒万龙之门=Hồng Hoang Vạn Long Môn
太阴勾魂圣人=Thái Âm Câu Hồn Thánh Nhân
混沌封印之地=Hỗn Độn Nơi Phong Ấn
虚空原本之界=Hư Không Nguyên Bản Giới
虚空无数神通=hư không vô số thần thông
断魂散弹枪阵=Đoạn Hồn Tán Đạn Thương Trận
太上感应秘术=Thái Thượng Cảm Ứng Bí Thuật
魔王们的赌局=Ván Cược Của Các Ma Vương
'审判之眼'='Đôi Mắt Thẩm Phán'
鲜血的主宰者=Tiên Huyết Chúa Tể Giả
噩梦神祭之环=Vòng Ác Mộng Thần Tế
狂风追云之术=Cuồng Phong Truy Vân Thuật
多重灵云呈祥=Đa Trọng Linh Vân Trình Tường
星辰陨落之女=Tinh Thần Vẫn Lạc Nữ
冰霜系的长矛=trường mâu hệ băng sương
神圣骑士之书=Sách Của Kỵ Sĩ Thần Thánh
铁线拳·冲劲=Thiết Tuyến Quyền·Xung Kình
铁线拳·捶劲=Thiết Tuyến Quyền·Chùy Kình
铁线拳·甩劲=Thiết Tuyến Quyền·Súy Kình
守备管理局长=Cục Trưởng Quản Lí Phòng Giữ
原画和模型师=Nguyên Hoạ và Mô Hình Sư
罪狱召唤之杖=Tội Ngục Triệu Hoán Trượng
黑暗封印之书=Hắc Ám Phong Ấn Chi Thư
九幽怨灵之山=Cửu U Oán Linh Sơn
万堕恶鬼之王=Vạn Đọa Ác Quỷ Vương
阴暗骸骨之母=Âm Ám Hài Cốt Mẫu
苍白阴影之冠=Thương Bạch Âm Ảnh Quan
人间武道集团=Nhân Gian Võ Đạo Tập Đoàn
钙镁锌液体钙=viên uống Kẽm Magie Canxi
太上感应篇=Thái Thượng Cảm Ứng Thiên
基因众生谱=Gien Chúng Sinh Phổ
神明的战甲=Thần Minh Chiến Giáp
九转放灵诀=Cửu Chuyển Phóng Linh Quyết
风雷光暗音=Phong Lôi Quang Ám Âm
金焰的神灵=Kim Diễm Thần Linh
六界神山剑=Lục Giới Thần Sơn Kiếm
超级神灵体=Siêu Cấp Thần Linh Thể
记忆库秘匙=Ký Ức Khố Bí Thi
三千世界境=Tam Thiên Thế Giới Cảnh
灵魂撕裂者=Linh Hồn Tê Liệt Giả
灵魂尖啸者=Linh Hồn Tiêm Khiếu Giả
镇狱鬼王杖=Trấn Ngục Quỷ Vương Trượng
铁拳俱乐部=Thiết Quyền Câu Lạc Bộ
诸界的末日=Chư Giới Tận Thế
大寂灭星域=Đại Tịch Diệt Tinh Vực
星空大挪移=Tinh Không Đại Na Di
美杜莎之盾=Medusa Chi Thuẫn
阿修罗之泪=A Tu La Chi Lệ
刺杀者之枪=Thứ Sát Giả Thương
深渊织命者=Thâm Uyên Chức Mệnh Giả
因果报应刀=Nhân Quả Báo Ứng Đao
捕鲸生存刀=Bộ Kình Sinh Tồn Đao
地之造物者=Địa Chi Tạo Vật Giả
冰肌玉骨术=Băng Cơ Ngọc Cốt Thuật
阴阳空间币=Âm Dương Không Gian Tệ
血脉命神经=Huyết Mạch Mệnh Thần Kinh
魂琢刀套件=Hồn Mài Đao Sáo Kiện
千二百剑诀=Thiên Nhị Bách Kiếm Quyết
深渊嗜血魔=Thâm Uyên Thị Huyết Ma
真实幸运术=Chân Thực Hạnh Vận Thuật
地之双子星=Địa Chi Song Tử Tinh
皇极惊天拳=Hoàng Cực Kinh Thiên Quyền
布灵登石城=Bố Linh Đăng Thạch Thành
魔鬼召唤术=Ma Quỷ Triệu Hoán Thuật
万古大神山=Vạn Cổ Đại Thần Sơn
荆棘鸟王国=Kinh Cức Điểu Vương Quốc
大虚空神雷=Đại Hư Không Thần Lôi
魔网的拥抱=Ma Võng Ủng Bão
黑暗集骨者=Hắc Ám Tập Cốt Giả
魔龙弑灭者=Ma Long Thí Diệt Giả
暗杀者联盟=Ám Sát Giả Liên Minh
忘川离魂钩=Vong Xuyên Ly Hồn Câu
万物摧毁者=Vạn Vật Phá Hủy Giả
星之萤火虫=Tinh Chi Đom Đóm
神话级联盟=Thần Thoại Cấp Liên Minh
猎魔之战斧=Liệp Ma Chi Chiến Phủ
阿修罗神剑=A Tu La Thần Kiếm
恸罗日月遮=Đỗng La Nhật Nguyệt Già
毗摩智多罗=Bì Ma Trí Đa La
万灵灭魔剑=Vạn Linh Diệt Ma Kiếm
恒星撕裂剑=Hằng Tinh Tê Liệt Kiếm
恶鬼道之王=Ác Quỷ Đạo Chi Vương
恸罗日月斩=Đỗng La Nhật Nguyệt Trảm
维克那法眼=Wickner Pháp Nhãn
魔法大乌贼=Ma Pháp Đại Ô Tặc
自在天王境=Tự Tại Thiên Vương Cảnh
自在天王劫=Tự Tại Thiên Vương Kiếp
影青龙本咒=Ảnh Thanh Long Bản Chú
第五十七条=điều thứ năm mươi bảy
末日叩门者=Tận Thế Người Gõ Cửa
四臂双头猿=Tứ Tí Song Đầu Viên
咯咯咯咯咯=Ha ha ha ha ha
上古传 承=thượng cổ truyền thừa
轮回蚀灵沙=Luân Hồi Thực Linh Sa
虚空图书馆=Hư Không Thư Viện
功法修改器=Máy Sửa Chữa Công Pháp
圣言: 净=Thánh Ngôn: Tịnh
祭命之剑舞=Tế Mệnh Kiếm Vũ
圣托伦斯城=Thành Torrance
乌洛波洛斯=Ulopoulos
凶魔塔塔主=Hung Ma Tháp Tháp Chủ
黄金捕奴团=Hoàng Kim Bộ Nô Đoàn
影冰龙本咒=Ảnh Băng Long Bản Chú
影绿龙本咒=Ảnh Lục Long Bản Chú
影紫龙本咒=Ảnh Tử Long Bản Chú
影白龙本咒=Ảnh Bạch Long Bản Chú
影蓝龙本咒=Ảnh Lam Long Bản Chú
影金龙本咒=Ảnh Kim Long Bản Chú
忘川江之斩=Vong Xuyên Giang Trảm
命运之丝线=Vận Mệnh Sợi Tơ
神的休息间=Phòng Nghỉ Của Thần
强者之伴侣=Cường Giả Bạn Đồng Hành
罗德里法师=Rodri Pháp Sư
阿特洛波斯=Atropos
死亡次神技=Tử Vong Thứ Thần Kỹ
命运三姐妹=Vận Mệnh Ba Tỷ Muội
影灰龙本咒=Ảnh Hôi Long Bản Chú
任务制定师=Nhiệm Vụ Chế Định Sư
亡者佣兵团=Vong Giả Dong Binh Đoàn
血杀佣兵团=Huyết Sát Dong Binh Đoàn
陨光灭命者=Vẫn Quang Diệt Mệnh Giả
切尔诺贝利=Thảm họa Chernobyl
死亡河流的=Dòng Sông Tử Vong
守心静气的=thủ tâm tĩnh khí
白骨之甲具=Bạch Cốt Giáp Cụ
哗啦啦啦啦=rầm rầm rầm rầm rầm
百鬼噬血刀=Bách Quỷ Phệ Huyết Đao
百鬼嗜血刀=Bách Quỷ Thị Huyết Đao
索魄追命链=Tác Phách Truy Mệnh Liên
囚魂恶鬼扇=Tù Hồn Ác Quỷ Phiến
斩篇断章刀=Trảm Thiên Đoạn Chương Đao
万界俯视者=Kẻ Nhìn Xuống Vạn Giới
相位调换器=Tướng Vị Điều Hoán Khí
邪恶欺世者=Tà Ác Lấn Thế Giả
仙魔编辑器=Tiên Ma Biên Tập Khí
建木神珍铁=Kiến Mộc Thần Trân Thiết
流火锻身拳=Lưu Hỏa Đoán Thân Quyền
原初纯爱组=Nguyên Sơ Thuần Yêu Tổ
6 道神技=Lục Đạo Thần Kỹ
6 道诡事=Lục Đạo Quỷ Sự
6 道战争=Lục Đạo Chiến Tranh
九千一百号=số hiệu 9100
戮仙天魔曲=Lục Tiên Thiên Ma Khúc
5 行炼狱=Ngũ Hành Luyện Ngục
四圣柱之风=Tứ Thánh Trụ - Phong
万界俯瞰者=Người Quan Sát Vạn Giới
三百兆年的=ba trăm triệu năm
九星合众国=Cửu Tinh Hợp Chủng Quốc
永恒夺念者=Kẻ Đoạt Niệm Vĩnh Hằng
裂空九劫燕=Liệt Không Cửu Kiếp Yến
3 代死神=3 đời Tử Thần
过去的时代=quá khứ thời đại
过去的世界=quá khứ thế giới
这面的味道=hương vị mì này
疼疼疼疼疼=đau đau đau đau đau
嗡嗡嗡嗡嗡=Coong coong coong coong coong
咔咔咔咔咔=Tạch tạch tạch tạch tạch
众神记录者=Kẻ Ghi Chép Chúng Thần
永恒躲念者=Kẻ Đoạt Niệm Vĩnh Hằng
过去的自己=quá khứ chính mình
世界掌管者=Người Chưởng Quản Thế Giới
的真实之境=chân thực cảnh giới
古阿修罗王=Cổ A Tu La Vương
002 号=số 002
逆冰肌玉骨=Nghịch Băng Cơ Ngọc Cốt
虫族的道路=Trùng Tộc Đạo Lộ
剑修的道路=Kiếm Tu Đạo Lộ
第三七零号=Số Hiệu 370
第二十一号=Số hiệu 21
灭祭之末日=Diệt Tế Tận Thế
三六五九年=năm 3659
雷光崩解拳=Lôi Quang Băng Giải Quyền
雷光崩裂拳=Lôi Quang Băng Liệt Quyền
机械鬼步舞=Cơ Giới Quỷ Bộ Vũ
邪魔生死门=Tà Ma Sinh Tử Môn
九转轮回路=Cửu Chuyển Luân Hồi Lộ
无转万魔棺=Vô Chuyển Vạn Ma Quan
三百三十重=330 tầng
逆超级神体=Nghịch Siêu Cấp Thần Thể
维度记载者=Người Ghi Chép Vĩ Độ
第七十三号=số hiệu bảy mươi ba
邪魔之奥秘=Tà Ma Huyền Bí
逆基因物语=Nghịch Gien Vật Ngữ
三十九亿年=3.9 tỉ năm
诸末日之种=Chư Tận Thế Hạt Giống
三元保神丹=Tam Nguyên Bảo Thần Đan
过去的纪元=Quá Khứ Kỷ Nguyên
万剑镇魔索=Vạn Kiếm Trấn Ma Tác
万秘之眠术=Vạn Bí Miên Thuật
十八重地狱=mười tám tầng địa ngục
削骨鬼卒刀=Tước Cốt Quỷ Tốt Đao
因果律之线=dây luật nhân quả
的过去时光=quá khứ thời gian
过去四纪元=quá khứ bốn kỷ nguyên
历史记载者=Người Ghi Chép Lịch Sử
神翼天圣者=Thần Dực Thiên Thánh Giả
three=three
炼狱艺术家=Luyện Ngục Nghệ Thuật Gia
时空定位锚=Thời Không Định Vị Mỏ Neo
万寂敛息诀=Vạn Tịch Liễm Tức Quyết
水蕴灵宝扇=Thủy Uẩn Linh Bảo Phiến
灵光化雨术=Linh Quang Hóa Vũ Thuật
守夜人之书=Sách Người Gác Đêm
军械后备库=kho hậu bị quân giới
神兽降临符=Thần Thú Hàng Lâm Phù
破魔爆裂符=Phá Ma Bạo Liệt Phù
剥皮潜伏者=Kẻ Ẩn Nấp Lột Da
太上符印刀=Thái Thượng Phù Ấn Đao
太上忘情丹=Thái Thượng Vong Tình Đan
魔王的赌注=Ma Vương Tiền Đặt Cược
我的难题是=nan đề của ta là
03687=03687
神的放牧者=Kẻ Chăn Thả Của Thần
噩梦持火者=Kẻ Cầm Lửa Ác Mộng
超视距侦察=Siêu Thị Cự Trinh Sát
九幽燃血术=Cửu U Nhiên Huyết Thuật
香煎大白鱼=Hương Tiên Đại Bạch Ngư
旧日的神灵=Cựu Nhật Thần Linh
星辰卡牌师=Tinh Thần Thẻ Bài Sư
9 命猫妖=Cửu Mệnh Miêu Yêu
痛苦刑狱官=Thống Khổ Hình Ngục Quan
禁魔捕兽夹=Cấm Ma Bẫy Kẹp Bắt Thú
堕落卡牌师=Sa Đọa Thẻ Bài Sư
堕落咒术师=Sa Đọa Chú Thuật Sư
捕奴许可杖=Trượng Cho Bắt Nô
魔光泯灭炮=Ma Quang Mẫn Diệt Pháo
这场登神战=trận Đăng Thần Chiến này
灵能修习者=Linh Năng Tu Tập Giả
治愈类术法=loại chữa trị pháp thuật
枪械初学者=Người Mới Học Súng Ống
刺杀练习者=Người Luyện Tập Ám Sát
残破的圣契=Thánh Khế Tàn Phá
炼狱的烈犬=Luyện Ngục Liệt Khuyển
英年早逝班=Lớp Tráng Niên Mất Sớm
铁甲魔巨人=Thiết Giáp Ma Cự Nhân
雨·多重箭=Vũ·Đa Trọng Tiễn
'准备间'='Buồng Chuẩn Bị'
"准备间"="Buồng Chuẩn Bị"
魔神裂波掌=Ma Thần Liệt Ba Chưởng
腐骨顺劈斩=Hủ Cốt Thuận Phách Trảm
克里斯提娜=Christina
市第二中学=trung học thành phố 02
联合世界历=lịch Liên Hợp Thế Giới
食尸鬼之王=Thực Thi Quỷ Vương
葡萄糖酸钙=Canxi gluconat
阴影兄弟会=Bóng Ma Huynh Đệ Hội
伏虎十七掌=Phục Hổ Thập Thất Chưởng
南河连环腿=Nam Hà Liên Hoàn Thối
赤霄剑灵道=Xích Tiêu kiếm linh đạo
小尤利西斯=Tiểu Ulysses
怨仇阴阳诀=Oán Cừu Âm Dương Quyết
荒云天宫=Hoang Vân Thiên Cung
荒云宫主=Hoang Vân Cung Chủ
灵玉之花=Linh Ngọc Hoa
移形换影=Di Hình Hoán Ảnh
太上族长=Thái Thượng Tộc Trưởng
极境之术=Cực Cảnh Thuật
狄摩高根=Địch Ma Cao Căn
幽冥魂魔=U Minh Hồn Ma
妙音峰主=Diệu Âm Phong Chủ
荒云主峰=Hoang Vân Chủ Phong
龙影离空=Long Ảnh Ly Không
死亡之蝶=Tử Vong Chi Điệp
死亡蝶影=Tử Vong Điệp Ảnh
基因神榜=Gien Thần Bảng
灭灯之战=Diệt Đăng Chi Chiến
基因神殿=Gien Thần Điện
神灵之身=Thần Linh Chi Thân
时间之鬼=Thời Gian Quỷ
墨羽神鸟=Mặc Vũ Thần Điểu
沧海魔车=Thương Hải Ma Xa
红矮星宫=Hồng Ải Tinh Cung
荒云七峰=Hoang Vân Thất Phong
七剑之主=Thất Kiếm Chi Chủ
掌门之令=Chưởng Môn Lệnh
灵气逼人=Linh Khí Bức Nhân
时间凝固=Thời Gian Ngưng Cố
时空凝固=Thời Không Ngưng Cố
四臂天王=Tứ Tí Thiên Vương
好色行者=Hảo Sắc Hành Giả
冰蝉银面=Băng Thiền Ngân Diện
屠神之人=Đồ Thần Chi Nhân
刀锋女皇=Đao Phong Nữ Hoàng
三圣之殿=Tam Thánh Chi Điện
知识神殿=Tri Thức Thần Điện
自然神殿=Tự Nhiên Thần Điện
咒文之心=Chú Văn Chi Tâm
战士之眠=Chiến Sĩ Chi Miên
朦胧之域=Mông Lông Chi Vực
魔王之序=Ma Vương Chi Tự
混沌召唤=Hỗn Độn Triệu Hoán
冰霜甲衣=Băng Sương Giáp Y
变身女王=Biến Thân Nữ Vương
雷电生法=Lôi Điện Sinh Pháp
绝牙之力=Tuyệt Nha Chi Lực
荒古之门=Hoang Cổ Chi Môn
静音法阵=Tĩnh Âm Pháp Trận
原始天界=Nguyên Thủy Thiên Giới
红顶甲虫=Hồng Đính Giáp Trùng
无尽之剑=Vô Tẫn Chi Kiếm
空间穿梭=Không Gian Xuyên Toa
天萝神庙=Thiên La Thần Miếu
天萝骨枪=Thiên La Cốt Thương
天萝神枪=Thiên La Thần Thương
末日编年=Mạt Nhật Biên Niên
原始魔界=Nguyên Thủy Ma Giới
阴暗山界=Âm Ám Sơn Giới
阴影魔界=Âm Ảnh Ma Giới
极冰魔窟=Cực Băng Ma Quật
永夜深冰=Vĩnh Dạ Thâm Băng
邪歧魔王=Tà Kỳ Ma Vương
恶骨鬼王=Ác Cốt Quỷ Vương
邪歧之界=Tà Kỳ Giới
金焰神灵=Kim Diễm Thần Linh
邪歧魔界=Tà Kỳ Ma Giới
邪歧世界=Tà Kỳ Thế Giới
恶骨魔界=Ác Cốt Ma Giới
魔源宝钻=Ma Nguyên Bảo Toản
尖牙厉鬼=Tiêm Nha Lệ Quỷ
星空战场=Tinh Không Chiến Trường
阿修罗经=A Tu La Kinh
斩魂真瞳=Trảm Hồn Chân Đồng
镇天宫主=Trấn Thiên Cung Chủ
星空挪移=Tinh Không Na Di
弑神匕首=Thí Thần Chủy Thủ
空间跳跃=Không Gian Khiêu Dược
音陨命符=Âm Vẫn Mệnh Phù
翡冷之林=Phỉ Lãnh Chi Lâm
西荒之地=Tây Hoang Chi Địa
荒古之主=Hoang Cổ Chi Chủ
只见长矛=Chích Kiến Trường Mâu
寒冷之神=Hàn Lãnh Chi Thần
冰霜长杖=Băng Sương Trường Trượng
七彩长矛=Thất Thải Trường Mâu
天甲神牢=Thiên Giáp Thần Lao
神格武装=Thần Cách Võ Trang
黄金大门=Hoàng Kim Đại Môn
冥神孔雀=Minh Thần Khổng Tước
血脉之术=Huyết Mạch Chi Thuật
摩诃神象=Ma Ha Thần Tượng
神王权杖=Thần Vương Quyền Trượng
伤害加深=Thương Hại Gia Thâm
真赤魔枪=Chân Xích Ma Thương
战斗魔偶=Chiến Đấu Ma Ngẫu
不朽巨人=Bất Hủ Cự Nhân
四羊方尊=Tứ Dương Phương Tôn
谎言之神=Hoang Ngôn Chi Thần
流月仙宗=Lưu Nguyệt Tiên Tông
九十游寻=Cửu Thập Du Tầm
八百空轮=Bát Bách Không Luân
阴影源力=Âm Ảnh Nguyên Lực
悬空世界=Huyền Không Thế Giới
乱劫之风=Loạn Kiếp Phong
三千世界=Tam Thiên Thế Giới
霜结大地=Sương Kết Đại Địa
人族军团=Nhân Tộc Quân Đoàn
毁灭之主=Hủy Diệt Chi Chủ
极光始祖=Cực Quang Thủy Tổ
点灯之战=Điểm Đăng Chi Chiến
诅咒之弓=Trớ Chú Chi Cung
大力魔猿=Đại Lực Ma Viên
赋灵明光=Phú Linh Minh Quang
亡者之王=Vong Giả Chi Vương
永恒真神=Vĩnh Hằng Chân Thần
始皇之地=Thủy Hoàng Chi Địa
剑星皇子=Kiếm Tinh Hoàng Tử
葫芦玉佩=Hồ Lô Ngọc Bội
六界神山=Lục Giới Thần Sơn
原始魔母=Nguyên Thủy Ma Mẫu
灭界之锤=Diệt Giới Chùy
金焰之神=Kim Diễm Chi Thần
万界之塔=Vạn Giới Chi Tháp
真空魔龙=Chân Không Ma Long
序之魔王=Tự Chi Ma Vương
荆棘古树=Kinh Cức Cổ Thụ
金色短剑=Kim Sắc Đoản Kiếm
时间截流=Thời Gian Tiệt Lưu
怨骨鬼王=Oán Cốt Quỷ Vương
阴影穿梭=Âm Ảnh Xuyên Toa
无剑之剑=Vô Kiếm Chi Kiếm
邪歧魔族=Tà Kỳ Ma Tộc
黑雾战甲=Hắc Vụ Chiến Giáp
黑雾之拥=Hắc Vụ Ủng
抽灵之术=Trừu Linh Chi Thuật
黑骨巫王=Hắc Cốt Vu Vương
霸王雷刺=Phách Vương Lôi Thứ
苦海皆渡=Khổ Hải Giai Độ
风火双劫=Phong Hỏa Song Kiếp
寂静领主=Tịch Tĩnh Lãnh Chúa
0 灯明=Bách Đăng Minh
噬命灰炎=Phệ Mệnh Hôi Viêm
九命夺魂=Cửu Mệnh Đoạt Hồn
魔龙之血=Ma Long Huyết
游寻之劫=Du Tầm Kiếp
炙热之盾=Chích Nhiệt Thuẫn
守序邪恶=Thủ Tự Tà Ác
火焰长鞭=Hỏa Diễm Trường Tiên
神罚之剑=Thần Phạt Kiếm
自在天境=Tự Tại Thiên Cảnh
自在天王=Tự Tại Thiên Vương
须弥山主=Tu Di Sơn Chủ
四柱圣境=Tứ Trụ Thánh Cảnh
夜摩天境=Dạ Ma Thiên Cảnh
混乱之流=Hỗn Loạn Chi Lưu
封印之匙=Phong Ấn Chìa Khóa
狂犬之力=Cuồng Khuyển Chi Lực
死亡天使=Tử Vong Thiên Sứ
千眼战衣=Thiên Nhãn Chiến Y
一瞬千年=Nhất Thuấn Thiên Niên
水火双劫=Thủy Hỏa Song Kiếp
蝎魔召唤=Hạt Ma Triệu Hoán
画影万千=Họa Ảnh Vạn Thiên
地之世界=Địa Chi Thế Giới
律法之眼=Luật Pháp Chi Nhãn
廓尔喀刀=Khuếch Nhĩ Khách Đao
三角血刺=Tam Giác Huyết Thứ
地之圣柱=Địa Thánh Trụ
地之源力=Địa Nguyên Lực
地之双躯=Địa Chi Song Khu
九命血猫=Cửu Mệnh Huyết Miêu
深渊织命=Thâm Uyên Chức Mệnh
无眼巨兽=Vô Nhãn Cự Thú
黑骨战兵=Hắc Cốt Chiến Binh
魔王降临=Ma Vương Hàng Lâm
恶骨魔王=Ác Cốt Ma Vương
恶骨鬼界=Ác Cốt Quỷ Giới
刹那女帝=Sát Na Nữ Đế
光明之井=Quang Minh Giếng
光明井莲=Quang Minh Tỉnh Liên
恶灵之花=Ác Linh Hoa
祭命之舞=Tế Mệnh Vũ
寂静斗篷=Tịch Tĩnh Áo Choàng
永恒时刻=Vĩnh Hằng Thời Khắc
深渊潜魔=Thâm Uyên Tiềm Ma
荒云洞天=Hoang Vân Động Thiên
时空浸透=Thời Không Thẩm Thấu
透魔之镜=Thấu Ma Kính
虚空之风=Hư Không Chi Phong
荆棘王国=Kinh Cức Vương Quốc
石化蛛皇=Thạch Hóa Chu Hoàng
冰霜毒蚁=Băng Sương Độc Nghĩ
暗之禁锢=Ám Chi Cấm Cố
弑魂甲虫=Thí Hồn Giáp Trùng
时间蚀刻=Thời Gian Thực Khắc
虚空之洞=Hư Không Động
七星游龙=Thất Tinh Du Long
魔王黑旗=Ma Vương Hắc Kỳ
时间孤岛=Thời Gian Đảo Hoang
诸界门匙=Chư Giới Khóa Cửa
天之双生=Thiên Chi Song Sinh
地之双生=Địa Chi Song Sinh
妖精之朵=Yêu Tinh Chi Đóa
海底之书=Quyển Sách Đáy Biển
焰灵坠饰=Diễm Linh Hoa Tai
刹那女神=Sát Na Nữ Thần
公正女神=Công Chính Nữ Thần
死亡圣教=Tử Vong Thánh Giáo
穿梭时空=vượt qua thời không
冰肌玉骨=Băng Cơ Ngọc Cốt
刹那止境=Sát Na Chỉ Cảnh
刹那时针=Sát Na Kim Đồng Hồ
飞雪世界=Phi Tuyết Thế Giới
虚空龙王=Hư Không Long Vương
时之精灵=Thời Chi Tinh Linh
四柱之地=Tứ Trụ Chi Địa
古神之源=Cổ Thần Chi Nguyên
青铜战车=Thanh Đồng Chiến Xa
阴影之神=Âm Ảnh Chi Thần
不灭之沙=Bất Diệt Chi Sa
命运之剑=Vận Mệnh Kiếm
秽暗之书=Uế Ám Chi Thư
水花宝石=Thủy Hoa Bảo Thạch
于表世界=Vu Biểu Thế Giới
流沙世界=Lưu Sa Thế Giới
召魂图案=Triệu Hồn Đồ Án
恐惧之魔=Khủng Cụ Ma
个人情报=cá nhân tình báo
夜色酒吧=Dạ Sắc Quán Bar
火山世界=Hỏa Sơn Thế Giới
永恒深渊=vĩnh hằng vực sâu
刀锋之誓=Đao Phong Chi Thệ
深渊魔龙=Vực Sâu Ma Long
万古神城=Vạn Cổ Thần Thành
恶灵地泉=Ác Linh Địa Tuyền
血海军神=Huyết Hải Quân Thần
隐语世界=Ẩn Ngữ Thế Giới
焰噬魔界=Diễm Phệ Ma Giới
古之恶兽=Cổ Chi Ác Thú
开拓之斧=Khai Thác Chi Phủ
寒冬之戒=Hàn Đông Chi Giới
血核王冠=Huyết Hạch Vương Quan
污秽之言=Ô Uế Chi Ngôn
黑暗圣言=Hắc Ám Thánh Ngôn
青春之泉=Thanh Xuân Tuyền
虚空之丝=Hư Không Tơ
幽暗地域=U Ám Địa Vực
长老之眼=Trường Lão Chi Nhãn
寒霜之戒=Hàn Sương Giới Chỉ
元素王子=Nguyên Tố Vương Tử
雄伟之主=Hùng Vĩ Chi Chủ
魔网拥抱=Ma Võng Ủng Bão
荆棘之船=Kinh Cức Thuyền
星辰之心=Tinh Thần Chi Tâm
深渊巨兽=Thâm Uyên Cự Thú
欧阳秋山=Âu Dương Thu Sơn
紫毛猴子=Tử Mao Hầu Tử
世界之术=Thế Giới Chi Thuật
生命之序=Sinh Mệnh Chi Tự
死海雾岛=Tử Hải Vụ Đảo
烟火成城=Yên Hỏa Thành Thành
谎言宝球=Hoang Ngôn Bảo Cầu
原与圣城=Nguyên Dữ Thánh Thành
基因物语=Gien Vật Ngữ
散播之主=Tán Bá Chi Chủ
混乱使者=Hỗn Loạn Sứ Giả
残肢使者=Tàn Chi Sứ Giả
混乱残肢=Hỗn Loạn Tàn Chi
混乱七罪=Hỗn Loạn Thất Tội
混乱瘟疫=Hỗn Loạn Ôn Dịch
混乱乱世=Hỗn Loạn Loạn Thế
混乱虐杀=Hỗn Loạn Ngược Sát
闪电海鹫=Thiểm Điện Hải Thứu
深渊之王=Vực Sâu Chi Vương
命运之王=Vận Mệnh Chi Vương
友爱之手=Hữu Ái Chi Thủ
星云世界=Tinh Vân Thế Giới
双刃刺客=Song Nhận Thích Khách
暗血之蛹=Ám Huyết Kén
神武世界=Thần Võ Thế Giới
无为道宫=Vô Vi Đạo Cung
世界之塔=Thế Giới Chi Tháp
死亡暗鸦=Tử Vong Ám Nha
时空迷巢=Thời Không Mê Tổ
四柱之祭=Tứ Trụ Chi Tế
地神之舞=Địa Thần Chi Vũ
地之禁绝=Địa Chi Cấm Tuyệt
报终之犬=Báo Chung Chi Khuyển
命运之书=Vận Mệnh Chi Thư
魔鬼之火=Ma Quỷ Chi Hỏa
忠贞之戒=Trung Trinh Chi Giới
登神之路=Con Đường Thành Thần
静寂之城=Tĩnh Tịch Chi Thành
圣文白鹿=Thánh Văn Bạch Lộc
死亡圣堂=Tử Vong Thánh Đường
死亡之力=Tử Vong Chi Lực
秘法教宗=Bí Pháp Giáo Hoàng
秘法神殿=Bí Pháp Thần Điện
混乱神只=Hỗn Loạn Thần Chỉ
混乱之敌=Kẻ Địch Của Hỗn Loạn
掠杀使者=Lược Sát Sứ Giả
紫羽幽梦=Tử Vũ U Mộng
天神之序=Thiên Thần Chi Tự
锋之葬刀=Phong Chi Táng Đao
断魂匕首=Đoạn Hồn Chủy Thủ
疾风水晶=Tật Phong Thủy Tinh
搜寻之猫=Sưu Tầm Chi Miêu
爱的摸摸=Ái Mạc Mạc
邪恶之血=Tà Ác Chi Huyết
恶魔术士=Ác Ma Thuật Sĩ
脱网之翅=Thoát Võng Chi Sí
深渊之底=Vực Sâu Đáy
空之祭岛=Không Chi Tế Đảo
星辉帝国=Tinh Huy Đế Quốc
万界庇护=Vạn Giới Che Chở
8 音虫=Bát Âm Trùng
万神之死=Vạn Thần Chi Tử
万神之国=Vạn Thần Chi Quốc
圣灵之护=Thánh Linh Chi Hộ
生命之神=Thần Sinh Mệnh
元素之御=Nguyên Tố Chi Ngự
寒冰之歌=Hàn Băng Chi Ca
冰风之歌=Băng Phong Chi Ca
尸柱之林=Thi Trụ Chi Lâm
死渊之地=Tử Uyên Chi Địa
时空谜巢=Thời Không Mê Tổ
虚空神只=Hư Không Thần Chích
疾攻之术=Tật Công Thuật
奇诡之灵=Kỳ Quỷ Chi Linh
圆月连斩=Viên Nguyệt Liên Trảm
星火战神=Tinh Hỏa Chiến Thần
虚空之路=Hư Không Chi Lộ
虚空战神=Hư Không Chiến Thần
妖兽元年=Yêu Thú Nguyên Niên
血刃武馆=Huyết Nhận Võ Quán
天空之心=Thiên Không Chi Tâm
无双剑姬=Vô Song Kiếm Cơ
蜘蛛王座=Tri Chu Vương Tọa
无常双蛇=Vô Thường Song Xà
黑衣勾魂=Hắc Y Câu Hồn
白衣还命=Bạch Y Hoàn Mệnh
众鬼之王=Chúng Quỷ Chi Vương
虚无之焰=Hư Vô Chi Diễm
云图之绳=Vân Đồ Chi Thằng
星辉九府=Tinh Huy Cửu Phủ
百千神技=Bách Thiên Thần Kỹ
斩魂魔刃=Trảm Hồn Ma Nhận
万神帝君=Vạn Thần Đế Quân
霜火既成=Sương Hỏa Ký Thành
一剑离火=Nhất Kiếm Ly Hỏa
一剑霜锋=Nhất Kiếm Sương Phong
日月来遮=Nhật Nguyệt Lai Già
霜灭剑法=Sương Diệt Kiếm Pháp
火毁剑法=Hỏa Hủy Kiếm Pháp
镇魔之兵=Trấn Ma Chi Binh
魂引之术=Hồn Dẫn Chi Thuật
紫盔大蛇=Tử Khôi Đại Xà
九副星图=Cửu Phó Tinh Đồ
九面星辉=Cửu Diện Tinh Huy
狂暴虎哥=Cuồng Bạo Hổ Ca
时光长河=Thời Gian Trường Hà
七彩之矛=Thất Thải Chi Mâu
深渊之盟=Vực Sâu Liên Minh
蕾妮朵尔=Reneedol
诸界之玉=Chư Giới Chi Ngọc
万神女帝=Vạn Thần Nữ Đế
血海神兵=Huyết Hải Thần Binh
阿修罗王=A Tu La Vương
契约之王=Khế Ước Chi Vương
火焰峡谷=Hỏa Diễm Hạp Cốc
炼狱魔鬼=Luyện Ngục Ma Quỷ
炼狱之犬=Luyện Ngục Khuyển
黑火尊者=Hắc Hỏa Tôn Giả
猫妖之变=Miêu Yêu Chi Biến
黑暗尊者=Hắc Ám Tôn Giả
魔罗天王=Ma La Thiên Vương
时之女士=Thời Chi Nữ Sĩ
双叉法杖=Song Xoa Pháp Trượng
黄泉借法=Hoàng Tuyền Tá Pháp
封尸转阴=Phong Thi Chuyển Âm
魂归去来=Hồn Quy Khứ Lai
妖法之木=Yêu Pháp Mộc
破魔巨象=Phá Ma Cự Tượng
阿修罗道=A Tu La Đạo
黑白双蛇=Hắc Bạch Song Xà
初之巨人=Sơ Chi Cự Nhân
万界神王=Vạn Giới Thần Vương
时光之河=sông thời gian
万籁之主=Vạn Lại Chi Chủ
沉眠之召=Trầm Miên Triệu Tập
世界之祭=Thế Giới Chi Tế
七彩之盾=Thất Thải Thuẫn
渊之圣盾=Uyên Chi Thánh Thuẫn
深渊契咒=Vực Sâu Khế Chú
噬命巨虫=Phệ Mệnh Cự Trùng
渊寒怪手=Uyên Hàn Quái Thủ
荒芜魔蛇=Hoang Vu Ma Xà
夜行刀魔=Dạ Hành Đao Ma
六臂蛇魔=Lục Tí Xà Ma
鬼门之神=Quỷ Môn Chi Thần
生死轮转=Sinh Tử Luân Chuyển
碎片世界=mảnh vỡ thế giới
夜摩天劫=Dạ Ma Thiên Kiếp
天香神泉=Thiên Hương Thần Tuyền
我之居所=Ngã Chi Cư Sở
须弥山劫=Tu Di Sơn Kiếp
自在天劫=Tự Tại Thiên Kiếp
天柱世界=Thiên Trụ Thế Giới
天柱之城=Thiên Trụ Thành
铁剑横江=Thiết Kiếm Hoành Giang
万首镇压=Vạn Thủ Trấn Áp
魔罗之弓=Ma La Chi Cung
焚香之殿=Phần Hương Chi Điện
不周山断=Bất Chu Sơn Đoạn
迷巢世界=Mê Sào Thế Giới
光音世界=Quang Âm Thế Giới
熔火世界=Dung Hỏa Thế Giới
通天之柱=Thông Thiên Trụ
星河圣人=Tinh Hà Thánh Nhân
青鳞龙盾=Thanh Lân Long Thuẫn
源流之跃=Nguyên Lưu Dược
颠倒仙湖=Điên Đảo Tiên Hồ
天仙古城=Thiên Tiên Cổ Thành
妙手医圣=Diệu Thủ Y Thánh
鬼饲虎王=Quỷ Tự Hổ Vương
游骑散将=Du Kỵ Tán Tướng
十剑之海=Thập Kiếm Chi Hải
妖凤大人=Yêu Phượng Đại Nhân
九星洗海=Cửu Tinh Tẩy Hải
十轮神技=Thập Luân Thần Kỹ
鬼风之术=Quỷ Phong Thuật
恶厌替法=Ác Yếm Thế Pháp
替死之术=Thế Tử Thuật
替死符术=Thế Tử Phù Thuật
面具之咒=Mặt Nạ Nguyền Rủa
万兽深窟=Vạn Thú Thâm Quật
镇邪之体=Trấn Tà Chi Thể
即死魔线=Tức Tử Ma Tuyến
时空硬币=Thời Không Tiền Xu
过去之匙=Chìa Khóa Quá Khứ
因果之符=Nhân Quả Phù
命符之术=Mệnh Phù Chi Thuật
自在神通=Tự Tại Thần Thông
震天大帝=Chấn Thiên Đại Đế
光之圣河=Quang Chi Thánh Hà
迷拉迪亚=Miradia
夜魅鬼影=Dạ Mị Quỷ Ảnh
幸运之绳=May Mắn Dây Thừng
六界山神=Lục Giới Sơn Thần
赤魔神枪=Xích Ma Thần Thương
人造世界=Nhân Tạo Thế Giới
断罪之枪=Đoạn Tội Chi Thương
禁绝之术=Cấm Tuyệt Chi Thuật
混乱之龙=Hỗn Loạn Chi Long
沉秘之海=Trầm Bí Hải
烈焰行者=Liệt Diễm Hành Giả
火焰行者=Hỏa Diễm Hành Giả
美合众国=Mỹ
花都巴黎=Hoa Đô Paris
黄沙狮皇=Hoàng Sa Sư Hoàng
大力神拳=Đại Lực Thần Quyền
银翼飞蚁=Ngân Dực Phi Nghĩ
夕阳学院=Tịch Dương Học Viện
忘川魂归=Vong Xuyên Hồn Quy
众生之序=Chúng Sinh Chi Tự
氪金母猪=Khắc Kim Mẫu Trư
利爪虎王=Lợi Trảo Hổ Vương
特战队长=Đặc chiến đội trưởng
腐蚀之源=Hủ Thực Chi Nguyên
万龙之祖=Vạn Long Tổ
依附之主=Y Phụ Chi Chủ
时空坟墓=Thời Không Phần Mộ
祭祀权杖=Tế Tự Quyền Trượng
时空之祭=Thì Không Chi Tế
终极剑舞=Chung Cực Kiếm Vũ
剑祭之末=Kiếm Tế Chi Mạt
青龙本咒=Thanh Long Bản Chú
万族军团=Vạn Tộc Quân Đoàn
三龙之力=Tam Long Chi Lực
赴月之鹰=Phó Nguyệt Chi Ưng
灵德天书=Linh Đức Thiên Thư
功德善书=Công Đức Thiện Thư
山海流派=Sơn Hải Lưu Phái
尸骨之塔=Thi Cốt Tháp
画骨幽女=Họa Cốt U Nữ
唤血之骨=Hoán Huyết Cốt
万圣刀尊=Vạn Thánh Đao Tôn
山海栖霞=Sơn Hải Tê Hà
百灭圣手=Bách Diệt Thánh Thủ
拥骨老人=Ủng Cốt Lão Nhân
源流之诀=Nguyên Lưu Quyết
万山之祖=Vạn Sơn Chi Tổ
天命宝盒=Thiên Mệnh Bảo Hạp
不动之甲=Bất Động Giáp
替换之术=Thay Thế Thuật
命运之果=Vận Mệnh Quả
百花圣人=Bách Hoa Thánh Nhân
白首尊者=Bạch Thủ tôn giả
山海宗主=Sơn Hải tông chủ
阴影之手=Âm Ảnh Chi Thủ
死亡铡刀=Tử Vong Trát Đao
恐惧魔王=Khủng Cụ Ma Vương
刺客皇帝=Thích Khách Hoàng Đế
禁魔法阵=Cấm Ma Pháp Trận
墟之帝国=Khư Đế Quốc
噬脑魔虫=Phệ Não Ma Trùng
迷洞魔虫=Mê Động Ma Trùng
圣辉教会=Thánh Huy Giáo Hội
制卡技术=kỹ thuật chế thẻ
剥心魔刺=Bác Tâm Ma Thứ
虚空之花=Hư Không Hoa
直死银鸦=Trực Tử Ngân Nha
罪狱龙王=Tội Ngục Long Vương
三三七号=số 337
幽暗星域=U Ám Tinh Vực
白鹰龚五=Bạch Ưng Cung Ngũ
飞鸟一族=Phi Điểu nhất tộc
铁剑拦江=Thiết Kiếm Lan Giang
幽暗岩星=U Ám Nham Tinh
九域世界=Cửu Vực Thế Giới
流光禁典=Lưu Quang Cấm Điển
瓶冷蔺草=Bình Lãnh Lận Thảo
秘解协会=Bí Giải Hiệp Hội
死途终影=Tử Đồ Chung Ảnh
瘟疫之鬼=Ôn Dịch Quỷ
玩偶鸭子=con rối búp bê
圣灵世界=Thánh Linh Thế Giới
丰收之神=Thần Bội Thu
凋零之神=Điêu Linh Thần
晨曦之主=Thần Hi Chi Chủ
至位之神=Chí Vị Chi Thần
惩戒之钟=chuông trừng trị
九列公国=Cửu Liệt Công Quốc
断罪法典=Đoạn Tội Pháp Điển
冰霜之泉=Băng Sương Tuyền
战争之神=Thần Chiến Tranh
陨星归位=Sao Băng Quy Vị
黑血猎豹=Hắc Huyết Liệp Báo
至高森林=Chí Cao Sâm Lâm
弗仑公国=Không Luân Công Quốc
深渊底端=đáy vực sâu
混乱之蛇=Hỗn Loạn Xà
毁灭之蛇=Hủy Diệt Xà
寒霜帝国=Hàn Sương đế quốc
太阴仙符=Thái Âm Tiên Phù
恶念焚神=Ác Niệm Đốt Thần
凶魔塔主=Hung Ma Tháp Chủ
虚空乱流=Hư Không Loạn Lưu
城主之女=Thành Chủ con gái
定界神剑=Định Giới Thần Kiếm
星河之劫=Tinh Hà Kiếp
血海魔主=Huyết Hải Ma Chủ
黄泉之劫=Hoàng Tuyền Kiếp
南华道界=Nam Hoa Đạo Giới
圣选之珠=Thánh Tuyển Châu
痴傻之咒=Ngu Dại Chú
墓葬之地=Nơi Mộ Táng
天国世界=Thiên Quốc Thế Giới
司命魔种=Tư Mệnh Ma Chủng
黄泉路引=Hoàng Tuyền Lộ Dẫn
忘川之水=Vong Xuyên Thủy
祛幻命符=Khư Huyễn Mệnh Phù
无生末日=Vô Sinh Tận Thế
早死之术=Thuật Chết Sớm
童子之身=thân đồng tử
星辰凝光=Tinh Thần Ngưng Quang
星辰之术=Tinh Thần Thuật
瑶光倾落=Dao Quang Khuynh Lạc
扶摇冲霄=Phù Diêu Trùng Tiêu
星辰术法=Tinh Thần Pháp Thuật
仙人家族=Tiên Nhân gia tộc
沧海仙殿=Thương Hải Tiên Điện
世界之壁=Vách Tường Thế Giới
恶鬼之选=Ác Quỷ Chi Tuyển
米粒之光=Mễ Lạp Quang
六道恶面=Lục Đạo Ác Diện
玉树深影=Ngọc Thụ Thâm Ảnh
沧海仙船=Thương Hải Tiên Thuyền
面咒之术=Diện Chú Thuật
云纹仙玉=Vân Văn Tiên Ngọc
鬼杀之面=Quỷ Sát Diện
真空裂斩=Chân Không Liệt Trảm
恶鬼之咒=Ác Quỷ Chú
黑暗隧道=Hắc Ám Đường Hầm
万地之母=Vạn Địa Chi Mẫu
万神之王=Vạn Thần Chi Vương
封印之章=Phong Ấn Chương
雷妮朵尔=Reneedol
世界之谷=Thế Giới Cốc
巨人之森=Cự Nhân Sâm
野性之城=Dã Tính Thành
白银之国=Bạch Ngân Quốc
白银之傲=Bạch Ngân Ngạo
命运双树=Vận Mệnh Song Thụ
法则巨兽=Pháp Tắc Cự Thú
死亡之线=Dây Tử Vong
极北之地=nơi cực bắc
蕾妮朵儿=Reneedol
进化之章=Tiến Hóa Chương
众生同调=Chúng Sinh Đồng Điều
法则之主=Pháp Tắc Chi Chủ
死亡法则=Tử Vong Pháp Tắc
光之源力=Quang Nguyên Lực
预言之神=Tiên Đoán Thần
死亡之狼=Tử Vong Lang
阿布鲁息=Aboul
万神之地=Nơi Ở Của Vạn Thần
拉克茜斯=Laques
隐语之神=Ẩn Ngữ Thần
死亡低语=Lời Thì Thầm Của Tử Vong
庇护之岛=Đảo Che Chở
三生之祭=Tam Sinh Tế
剑舞之祭=Kiếm Vũ Tế
恢弘之网=Khôi Hoằng Võng
死亡野兽=Tử Vong Dã Thú
九针负重=Cửu Châm Phụ Trọng
星辰之弓=Tinh Thần Cung
虚无之神=Hư Vô Thần
石化之神=Thạch Hóa Thần
灰褐之龙=Hôi Hạt Long
末日之王=Tận Thế Chi Vương
生命之书=Sinh Mệnh Chi Thư
预言之灵=Tiên Đoán Chi Linh
天鬼之面=Thiên Quỷ Diện
府都七鬼=Phủ Đô Thất Quỷ
百里天涯=Bách Lý Thiên Nhai
冰雪神庙=Băng Tuyết Thần Miếu
死斗之舞=Tử Đấu Vũ
澜江鬼雄=Lan Giang Quỷ Hùng
战争之王=Chiến Tranh Chi Vương
六道甜狗=Lục Đạo Điềm Cẩu
李大白话=Lý Đại Bạch Thoại
死斗之祭=Tử Đấu Tế
紫衫公子=Tử Sam Công Tử
流沙封印=Lưu Sa Phong Ấn
首尾无踪=Thủ Vĩ Vô Tung
冰封之嗅=Băng Phong Khứu
闪耀之城=Thiểm Diệu Thành
死亡之河=Tử Vong Hà
红龙本咒=Công Long Bản Chú
星辰团长=Tinh Thần đoàn trưởng
亡者团长=Vong Giả đoàn trưởng
巫毒术师=Vu Độc Thuật Sư
拉玛塔塔=Ramata
死河之水=Tử Hà Thủy
硅基病毒=virus gốc Silic
公路之歌=Công Lộ Ca
黑暗之火=Hắc Ám Hỏa
死亡之龙=Tử Vong Long
火之气息=Hỏa Khí Tức
光之巨墙=Ánh sáng tường lớn
影之末日=Tận Thế Ảnh
阅后即焚=Xem xong liền đốt
杀戮小丑=Sát Lục Thằng Hề
杀戮舞团=Sát Lục Vũ Đoàn
妖精魔泉=Yêu Tinh Ma Tuyền
深血之海=Thâm Huyết Hải
顾. .=Cố. .
血海之中=Huyết Hải bên trong
断罪之书=Đoạn Tội Chi Thư
过去之钥=Chìa Khóa Quá Khứ
过去鬼身=Quá Khứ Quỷ Thân
影傀之陷=Ảnh Khôi Hãm
冰封之拥=Băng Phong Ủng
冰封之握=Băng Phong Ác
神灵之手=Thần Linh Chi Thủ
百花师徒=Bách Hoa sư đồ
时之末日=Thời Gian Tận Thế
莫测之境=Khó Lường Cảnh
深魔之禁=Thâm Ma Cấm
万欲琉璃=Vạn Dục Lưu Ly
腐朽之术=Hủ Hủ Thuật
山鬼之噬=Sơn Quỷ Phệ
末日之境=tận thế cảnh giới
命运双界=Vận Mệnh Song Giới
神兵之主=chủ nhân Thần Binh
龙祖本咒=Long Tổ Bản Chú
等待者们=đám Người Chờ Đợi
圣灵帝国=Thánh Linh Đế Quốc
虚无之墙=Hư Vô Bức Tường
通行之匙=Chìa Khóa Thông Hành
回返之术=Hồi Phản Thuật
无因之剑=Vô Nhân Kiếm
奇诡之骨=Kỳ Quỷ Cốt
荆棘之王=Kinh Cức Vương
无因剑法=Vô Nhân Kiếm Pháp
千二百剑=1200 kiếm
时间之碑=Tấm Bia Thời Gian
纯洁之男=Thuần Khiết Nam
四面魔王=Tứ Diện Ma Vương
英灵殿主=Anh Linh Điện Chủ
血界灵目=Huyết Giới Linh Mục
界灵之降=Giới Linh Hàng
"无因"="Vô Nhân"
邪之圣物=Tà Chi Thánh Vật
六道争雄=Lục Đạo Tranh Hùng
灰暗旧城=U Ám Cựu Thành
钟塔世界=Chung Tháp Thế Giới
转生薄主=Chuyển Sinh Bạc Chủ
幽影夜王=U Ảnh Dạ Vương
雷芒闪动=Lôi Mang Thiểm Động
圣界之轮=Thánh Giới Chi Luân
战争之器=chiến tranh khí cụ
荆棘之血=Kinh Cức máu
真古之魔=Chân Cổ Chi Ma
血海圣柱=Huyết Hải Thánh Trụ
波澜剑意=Gợn Sóng Kiếm Ý
九重浪鱼=Cửu Trọng Lãng Ngư
逆广寒经=Nghịch Nghiễm Hàn Kinh
死亡剪影=Tử Vong Tiễn Ảnh
冥界剪纸=Minh Giới Tiễn Chỉ
混血鳞片=Hỗn Huyết Lân Phiến
圣徒之拥=Thánh Đồ Ủng
相位界面=Tướng Vị giao diện
世界之石=Thế Giới Thạch
传送之丝=Tơ Truyền Tống
远古光魔=Viễn Cổ Quang Ma
灭魂普照=Diệt Hồn Phổ Chiếu
王牌刺客=Vương Bài Thích Khách
邪恶之徒=Kẻ Tà Ác
精灵之泪=Tinh Linh Nước Mắt
钟楼世界=Chung Lâu thế giới
血月大人=Huyết Nguyệt đại nhân
忘川江畔=bờ sông Vong Xuyên
替命契约=Thế Mệnh Khế Ước
圣徒之甲=Thánh Đồ Giáp
欺世之王=Lấn Thế Vương
角斗之王=Giác Đấu Chi Vương
昨日之界=Giới Hôm Qua
六道天帝=Lục Đạo Thiên Đế
平均一下=chia đều một cái
血影神凰=Huyết Ảnh Thần Hoàng
逆时冥龙=Nghịch Thời Minh Long
饿鬼世界=Ngạ Quỷ Thế Giới
西邙古墓=Tây Mang Cổ Mộ
轮回幽兰=Luân Hồi U Lan
三誾之蜥=Tam Ngân Chi Tích
五行土源=Ngũ Hành Thổ Nguyên
五行之乱=Ngũ Hành rối loạn
六道神技=Lục Đạo Thần Kỹ
一天才能=một ngày mới có thể
二十九重=hai mươi chín tầng
恐惧宫殿=Cung Điện Sợ Hãi
诸界魔王=Chư Giới Ma Vương
退时之术=Thoái Thời Gian Thuật
恐惧之主=Khủng Cụ Chi Chủ
恐惧之灭=Khủng Cụ Diệt
五行之战=Ngũ Hành Chi Chiến
轮回战鬼=Luân Hồi Chiến Quỷ
噬仙蛊虫=Phệ Tiên Cổ Trùng
通天之山=Thông Thiên Sơn
大地之德=Đại Địa Chi Đức
九天绝剑=Cửu Thiên Tuyệt Kiếm
恐惧君王=Khủng Cụ Quân Vương
过去尘缘=quá khứ trần duyên
九天秘录=Cửu Thiên Bí Lục
九天玄仙=Cửu Thiên Huyền Tiên
封印之索=Phong Ấn Dây
恶鬼噬法=Ác Quỷ Phệ Pháp
黄泉渡法=Hoàng Tuyền Độ Pháp
天界仙法=Thiên Giới Tiên Pháp
人间道法=Nhân Gian Đạo Pháp
修罗战法=Tu La Chiến Pháp
兽王化法=Thú Vương Hóa Pháp
五行炼狱=Ngũ Hành Luyện Ngục
4 圣柱=Tứ Thánh Trụ
五行怪物=Ngũ Hành Quái Vật
九天世界=Cửu Thiên thế giới
风魔妖鼠=Phong Ma Yêu Thử
功德之石=Công Đức Thạch
魂归去散=Hồn Quy Khứ Tán
阴影一族=Âm Ảnh nhất tộc
千魔之主=Thiên Ma Chi Chủ
野棘魅娘=Dã Cức mị nương
劫主之场=Kiếp Chủ Tràng
钢铁之城=tòa thành sắt thép
中技法则=Trung Kỹ Pháp Tắc
消隐之术=Tiêu Ẩn Thuật
绿龙之须=Râu Rồng Xanh
圣愿之树=Thánh Nguyện Thụ
冰霜之雨=Băng Sương Vũ
皇家使团=Hoàng gia sứ đoàn
雄鹰帝国=Hùng Ưng đế quốc
月落帝国=Nguyệt Lạc đế quốc
法术之镜=kính pháp thuật
考斯普雷=Cowespre
术咒之印=ấn thuật chú
星空机神=Tinh Không Cơ Thần
天帝神瞳=Thiên Đế Thần Đồng
天之瞳术=Thiên Chi Đồng Thuật
阴影邪魔=Âm Ảnh Tà Ma
炽烈炎魔=Sí Liệt Viêm Ma
魔中之魔=ma trong ma
点金成铁=Điểm Kim Thành Thiết
森罗剑界=Sâm La Kiếm Giới
剥命轮回=Bác Mệnh Luân Hồi
一元剑意=Nhất Nguyên Kiếm Ý
紫霞仙衣=Tử Hà Tiên Y
无为道祖=Vô Vi Đạo Tổ
雷光巨龙=Lôi Quang Cự Long
见一如万=gặp một như vạn
食野之苹=ăn táo ngoài đồng
恶鬼道主=Ác Quỷ Đạo Chủ
呦呦鹿鸣=hươu kêu ô ô
虚空之剑=Hư Không Kiếm
我的钱币=đồng tiền của ta
死亡世界=Tử Vong Thế Giới
星光巨龙=Tinh Quang Cự Long
秋水长剑=Thu Thủy Trường Kiếm
黑暗之鸟=Hắc Ám Điểu
死亡河流=dòng sông Tử Vong
光辉之暗=Quang Huy Chi Ám
神器之争=tranh giành Thần Khí
轮回殿主=Luân Hồi Điện Chủ
千重影界=Thiên Trọng Ảnh Giới
无灵之甲=Vô Linh Giáp
奥秘神技=Huyền Bí Thần Kỹ
术法之甲=Thuật Pháp Giáp
封印之钉=Phong Ấn Đinh
众海之王=Chúng Hải Chi Vương
万海之镇=Vạn Hải Trấn
忘川之佑=Vong Xuyên Phù Hộ
九幽归魂=Cửu U Quy Hồn
刑罚司主=Hình Phạt Tư Chủ
转生簿主=Chuyển Sinh Bộ Chủ
具现之相=cụ hiện hình ảnh
雷神双势=Lôi Thần Song Thế
过去时代=quá khứ thời đại
血海地狱=Huyết Hải Địa Ngục
弑神符兽=Thí Thần Phù Thú
轮回天书=Luân Hồi Thiên Thư
轮回神雷=Luân Hồi Thần Lôi
真古魔王=Chân Cổ Ma Vương
恶鬼之面=Ác Quỷ Diện
功德天书=Công Đức Thiên Thư
超视灵魂=Siêu Thị Linh Hồn
猿人氏族=Người Vượn Thị Tộc
避祸之羽=Tránh Họa Vũ
相位之表=Tương Vị Biểu
时之流沙=cát chảy thời gian
真古圣界=Chân Cổ Thánh Giới
青铜之主=Thanh Đồng Chi Chủ
森绿部落=Sâm Lục bộ lạc
流沙之握=Lưu Sa Ác
九星之序=Cửu Tinh Chi Tự
俯身之术=Phủ Thân Thuật
时间之沙=cát thời gian
掌控之灵=Chưởng Khống Chi Linh
永恒之翼=Cánh Vĩnh Hằng
三十一分=ba mươi mốt phút
十界圣法=Thập Giới Thánh Pháp
梦境之龙=Mộng Cảnh Long
维度之羽=Duy Độ Chi Vũ
终末之祭=Chung Mạt Chi Tế
庇护大陆=Tí Hộ Đại Lục
侧的力量=Trắc Lực Lượng
魔虫之王=Ma Trùng Chi Vương
死魂魔王=Tử Hồn Ma Vương
炼狱之火=Luyện Ngục Hỏa
魔焰炼狱=Ma Diễm Luyện Ngục
地之身躯=Địa Chi Thân Thể
恶毒之神=Thần Ác Độc
谋略之神=Thần Mưu Lược
诡计之神=Thần Quỷ Kế
奴役之神=Thần Nô Dịch
欲望之神=Thần Dục Vọng
财富之神=Thần Tài Phú
灾厄之神=Thần Tai Ách
厄运之神=Thần Vận Rủi
灾厄之刺=Tai Ách Gai
汝之死亡=tử vong của ngươi
知识之神=Thần Tri Thức 
杀戮之神=Thần Giết Chóc
旅行之神=Thần Lữ Hành
流沙之镜=Lưu Sa Kính
兵器之神=Thần Binh Khí
地神之锤=Địa Thần Chùy
山剑断法=Sơn Kiếm Đoạn Pháp
牢狱之神=Thần Lao Ngục
正义之神=Thần Chính Nghĩa
过去众神=Quá Khứ Chúng Thần
圣柱之殿=Thánh Trụ Điện
时间之镜=Thời Gian Kính
金属之神=Thần Kim Loại
魔法女神=Ma Pháp Nữ Thần
痛苦君王=Thống Khổ Quân Vương
虚空之主=Hư Không Chi Chủ
食圣之魔=Thực Thánh Chi Ma
永恒虫群=Vĩnh Hằng Bầy Trùng
混血之饮=nước uống hỗn hợp
无月之镇=Vô Nguyệt Trấn
月祭之术=Nguyệt Tế Thuật
圣柱之地=Thánh Trụ Chi Địa
圣柱之水=Thánh Trụ Chi Thủy
奇迹之力=kỳ tích lực lượng
虚空之王=Hư Không Vương
涓流之始=Suối Lưu Khởi Nguồn
圆月之斩=Viên Nguyệt Trảm
缔结之锤=Ký Kết Chùy
拘神夺形=Câu Thần Đoạt Hình
混沌之徒=Hỗn Độn Chi Đồ
导引之器=khí cụ dẫn đường
永恒甲虫=Vĩnh Hằng Giáp Trùng
三仙剑客=Tam Tiên Kiếm Khách
天琼剑客=Thiên Quỳnh Kiếm Khách
恒云剑宗=Hằng Vân Kiếm Tông
气慷而慨=khí thế hào hùng
混乱之风=Hỗn Loạn Gió
神兽之龟=Thần Thú Chi Quy
圣愿之祭=Thánh Nguyện Tế
勇烈之气=khí tức dũng liệt
应死之物=ứng tử vật
龙神之握=Long Thần Ác
尘封之图=Phủ Bụi Đồ
科技教会=Khoa Kỹ Giáo Hội
科学教会=Khoa Học Giáo Hội
梦幻之龙=Mộng Huyễn Long
神乱会长=Thần Loạn Hội Trưởng
逆超神体=Nghịch Siêu Thần Thể
夜神无月=Dạ Thần Vô Nguyệt
魔神灵剑=Ma Thần Linh Kiếm
魔神之气=Ma Thần Khí
破界之器=Phá Giới Khí
万虫之母=Vạn Trùng Mẫu
为我之奴=làm nô lệ ta
光之绳索=ánh sáng dây thừng
时停之地=Thời Gian Dừng Nơi
奥秘之术=Huyền Bí Thuật
虚空三术=Hư Không Tam Thuật
虫族道路=Trùng tộc đạo lộ
孤鸿飞仙=Cô Hồng Phi Tiên
新加入者=người mới gia nhập
一人万生=Nhất Nhân Vạn Sinh
万灵蒙昧=Vạn Linh Mông Muội
仙光妙乐=tiên quang diệu nhạc
破障神柱=Phá Chướng Thần Trụ
终极之墓=Chung Cực Mộ
轮回之书=Luân Hồi Chi Thư
序列之主=Danh Sách Chi Chủ
第十五号=Số hiệu 15
第四星时=Tinh Thời thứ tư
黑暗之猪=Hắc Ám Heo
令地显化=lệnh địa hiển hóa
雷光崩解=Lôi Quang Băng Giải
机械鬼步=Cơ Giới Quỷ Bộ
雷光耀世=Lôi Quang Diệu Thế
黄泉之圣=Hoàng Tuyền Thánh
身份申请=xin thân phận
雷电之主=Lôi Điện Chi Chủ
永灭之灵=Vĩnh Diệt Chi Linh
十八地狱=Muòi Tám Địa Ngục
无转之地=Nơi Vô Chuyển
灭世之魔=Diệt Thế Ma
人间之圣=Nhân Gian Thánh
天帝念法=Thiên Đế Niệm Pháp
过去之阵=Quá Khứ Trận
末日军团=Tận Thế Quân Đoàn
永灭之墟=Vĩnh Diệt Khư
纪元之灵=Kỷ Nguyên Chi Linh
魔皇之胄=Ma Hoàng Trụ
大凶之卦=quẻ đại hung
魔皇之甲=Ma Hoàng Giáp
灵念之环=Linh Niệm Hoàn
大凶之阵=Đại Hung Trận
魔网断灭=Ma Võng Đoạn Diệt
万界崩神=Vạn Giới Băng Thần
花之妖精=Hoa Yêu Tinh
九转归魂=Cửu Chuyển Quy Hồn
冰原神脉=Băng Nguyên Thần Mạch
冰玉妖姬=Băng Ngọc Yêu Cơ
邪性之魔=Tà Tính Ma
永灭之王=Vĩnh Diệt Chi Vương
命运转移=Vận Mệnh Chuyển Di
不祥之卵=Trứng Chẳng Lành
不灭之魔=Bất Diệt Ma
光明之主=Quang Minh Chi Chủ
阿修罗界=A Tu La giới
亡者君主=Vong Giả Quân Chủ
亡者君王=Vong Giả Quân Vương
洪荒之术=Hồng Hoang thuật
大铁围山=Đại Thiết Vi Sơn
后来之人=Người Đến Kế Thừa
圣律之主=Thánh Luật Chi Chủ
风雨圣人=Phong Vũ thánh nhân
风雨之圣=Phong Vũ Thánh
末日之种=Hạt Giống Tận Thế
力量之种=hạt giống lực lượng
奥秘之主=Huyền Bí Chi Chủ
噬灭汲魂=Phệ Diệt Cấp Hồn
风斩剑诀=Phong Trảm Kiếm Quyết
七彩神龙=Thất Thải Thần Long
流光龙枪=Lưu Quang Long Thương
无极逆转=Vô Cực Nghịch Chuyển
逆神灵体=Nghịch Thần Linh Thể
亿万之祭=Ức Vạn Tế
契约之咒=Khế Ước Chú
永劫之风=Vĩnh Kiếp Phong
四圣之纪=Tứ Thánh Kỷ
神殿之主=Thần Điện Chi Chủ
永灭之地=Vĩnh Diệt Chi Địa
时光一族=Thời Gian Nhất Tộc
混沌之墟=Hỗn Độn Chi Khư
时光之母=Thời Gian Mẫu
末日之盟=Tận Thế Liên Minh
时间之母=Thời Gian Mẫu
过去纪元=quá khứ kỷ nguyên
时之披风=Thời Chi Áo Choàng
流沙之拥=Lưu Sa Ủng
终末之尾=đuôi chung mạt kết thúc
人面魔鸟=Nhân Diện Ma Điểu
万鳞之殿=Vạn Lân Điện
疾风连斩=Tật Phong Liên Trảm
开山剑锤=Khai Sơn Kiếm Chùy
三世童子=Ba Đời Đồng Tử
侍剑童子=Thị Kiếm Đồng Tử
抱剑童子=Ôm Kiếm Đồng Tử (Bão Kiếm Đồng Tử)
复仇路标=Bản Chỉ Đường Báo Thù
无尽之握=Vô Tận Ác
星辰暴龙=Tinh Thần Bạo Long
刹那之神=Sát Na Thần
三十三天=Tam Thập Tam Thiên
毁灭之手=Bàn Tay Hủy Diệt
混沌之灵=Hỗn Độn Chi Linh
蒙昧披风=Mông Muội Áo Choàng
邪化七灵=Tà Hóa Thất Linh
诸咒之王=Chư Chú Chi Vương
万邪魔臂=Vạn Tà Ma Tí
七剑之圣=Thất Kiếm Thánh
乾元唤灵=Càn Nguyên Hoán Linh
风雷水暗=Phong Lôi Thủy Ám
虚空之刺=Hư Không Gai
离魂之主=Ly Hồn Chi Chủ
追魂夺元=Truy Hồn Đoạt Nguyên
野蛮秘剂=Dã Man Bí Tề
摇滚之夜=đêm Rock and Roll
天选之技=Thiên Tuyển Kĩ Năng
钢肌暴肉=Cương Cơ Bạo Nhục
初之末日=Ban sơ tận thế
平衡阴影=Cân Bằng Bóng Ma
混沌战神=Hỗn Độn Chiến Thần
留影玉简=Lưu Ảnh Ngọc Giản
火之纪元=Hỏa Chi Kỷ Nguyên
顺转术式=Thuận Chuyển Thuật Thức
文明魔方=Khối Rubik Nền Văn Minh
时光宝珠=Thời Gian Bảo Châu
过去使徒=Quá Khứ Sứ Đồ
时光之海=Thời Gian Đại Dương
历史观测=Quan Sát Lịch Sử
幻影之剑=Huyễn Ảnh Kiếm
魔虫之卵=ma trùng trứng
寄灵之符=Ký Linh Phù
极北圣教=Cực Bắc Thánh Giáo
时空流锚=Thời Không Lưu Neo
武道归藏=Võ Đạo Quy Tàng
能量换算=chuyển đổi năng lượng
火焰之虎=Hỏa Diễm Hổ
巨钳长螯=càng to sắc gọng
紧急路标=Biển Báo Giao Thông Khẩn Cấp
职业之书=sách nghề nghiệp
0371=0371
叮铃铃铃=reng reng reng reng
复生卡牌=Thẻ Phục Sinh
最赞之饮=Đồ Uống Ngon Nhất
见闻如名=Kiến Văn Như Danh
抚云仙宗=Phủ Vân Tiên Tông
真红之主=Chân Hồng Chi Chủ
音律攻术=Âm Luật Công Thuật
痛苦女士=Thống Khổ Nữ Sĩ
众生之术=Chúng Sinh Thuật
断魂之阵=Đoạn Hồn Trận
毁灭之火=Hủy Diệt Hỏa
永夜名号=Vĩnh Dạ danh hào
永夜魔鬼=Vĩnh Dạ ma quỷ
万雪冷木=Vạn Tuyết Lãnh Mộc
太上之术=Thái Thượng Thuật
引术灵纹=Dẫn Thuật Linh Văn
忘词状态=trạng thái quên lời
秘刀之术=Bí Đao Thuật
真红之血=Chân Hồng Huyết
避灵斗笠=Tị Linh Mũ
折磨始虫=Chiết Ma Thủy Trùng
爬行之主=Ba Hành Chi Chủ
咒语之主=Chú Ngữ Chi Chủ
画脸之术=Thuật Vẽ Mặt
画脸之符=Phù Vẽ Mặt
折磨之主=Chiết Ma Chi Chủ
太上除魔=Thái Thượng Trừ Ma
管窥之术=Quản Khuy Thuật
捕灵高手=Bộ Linh Cao Thủ
真实之书=Sách Chân Thật
灵魂赌注=Linh Hồn Tiền Đặt Cược
光泯灭炮=Quang Mẫn Diệt Pháo
重铠战士=Trọng Khải Chiến Sĩ
双龙追山=Song Long Truy Sơn
真名之选=Tuyển Chọn Tên Thật
无尽狱柱=Vô Tận Ngục Trụ
食人魔王=Thực Nhân Ma Vương
鲜血战圣=Tiên Huyết Chiến Thánh
奥法尊者=Áo Pháp Tôn Giả
回光倒影=Hồi Quang Đảo Ảnh
侧的兵器=trắc Binh Khí
世界之亡=Thế Giới Chi Vong
无存之岩=Vô Tồn Chi Nham
半选之神=Bán Tuyển Chi Thần
神赐时代=Thần Tứ thời đại
噩梦时代=Ác Mộng thời đại
五十四亿=5,4 tỷ
腐朽魔王=Hủ Hủ Ma Vương
血光突刺=Huyết Quang Đột Thứ
骸骨战马=hài cốt chiến mã
星辰之卡=Tinh Thần Thẻ
狱焰银行=Ngục Diễm Ngân Hàng
繁星之主=Phồn Tinh Chi Chủ
万丑之主=Vạn Sửu Chi Chủ
谎言之书=Sách Hoang Ngôn
审判之眼=Đôi Mắt Thẩm Phán
真视之眼=Mắt Nhìn Sự Thật
自由之翼=Đôi Cánh Tự Do
鬣狗之五=Linh Cẩu Chi Ngũ
痛苦女神=Thống Khổ Nữ Thần
旧日神灵=Cựu Nhật Thần Linh
星灵通道=Tinh Linh Thông Đạo
哒哒哒哒=cộc cộc cộc cộc
鲜血之主=Tiên Huyết Chi Chủ
永夜神柱=Vĩnh Dạ Thần Trụ
炼狱神柱=Luyện Ngục Thần Trụ
木石沙漠=Mộc Thạch sa mạc
修行世界=Tu Hành Thế Giới
魔道之主=Ma Đạo Chi Chủ
自然法诀=Tự Nhiên Pháp Quyết
真空斩法=Chân Không Trảm Pháp
星辰级别=cấp bậc Tinh Thần
真视魔镜=Chân Thị Ma Kính
九命猫妖=Cửu Mệnh Miêu Yêu
觅魔雏龙=Rồng Con Tìm Ma
不灭之骨=Bất Diệt Cốt
魔罗念刀=Ma La Niệm Đao
神斩贰式=Thần Trảm Nhị Thức
虚斩壹式=Hư Trảm Nhất Thức
万妖之王=Vạn Yêu Chi Vương
李伯塔斯=Libertas
燃命之法=phương pháp đốt mệnh
职业技能=nghề nghiệp kỹ năng
盾防之道=Thuẫn Phòng Chi Đạo
怨魂粉末=Bột Phấn Oan Hồn
银质匕首=Chủy Thủ Bạc
镶铁木盾=Thuẫn Khảm Thiết Gỗ
因果律侧=phương diện Luật Nhân Quả
折磨神位=Tra Tấn thần vị
登神之战=Đăng Thần Trận Chiến
霜冷之鸟=Sương Lãnh Điểu
血肉狩犬=Huyết Nhục Thú Khuyển
钢铁撕咬=Cương Thiết Tê Giảo
夜翼暗鬼=Dạ Dực Ám Quỷ
初之龙咒=Sơ Chi Long Chú
召唤术师=Triệu Hoán Thuật Sư
混血魔物=Hỗn Huyết Ma Vật
飞刺翼魔=Phi Thứ Dực Ma
霜寒之刺=Sương Hàn Gai
冰霜之友=Bạn Của Băng Sương
霜寒之爪=Móng Vuốt Sương Hàn
守狱骑士=Thủ Ngục Kỵ Sĩ
诅咒之火=Lửa Nguyền Rủa
万里归魂=Vạn Lý Quy Hồn
亡灵之书=Vong Linh Chi Thư
死亡魔窟=Tử Vong Ma Quật
劲歌热舞=Kình Ca Nhiệt Vũ
命运之线=dây vận mệnh
铁线流派=Thiết Tuyến lưu phái
铁手拦江=Thiết Thủ Lan Giang
唯樽酒吧=quán bar Duy Tôn
食神酒楼=Quán Rượu Thực Thần
铁线捶法=Thiết Tuyến Chùy Pháp
侧闪 (=Trắc Thiểm (
踏雪寻梅=Đạp Tuyết Tầm Mai
风雪独行=Phong Tuyết Độc Hành
骨龙之瞳=Con Mắt Cốt Long
掠魔领主=Lược Ma Lĩnh Chủ
万象森罗=Vạn Tượng Sâm La
铁线拳师=Thiết Tuyến Quyền Sư
深星之渊=Vực Sâu Thâm Tinh
吹息之刃=Xuy Tức Chi Nhận
T5通道=thông đạo T5
神赐纪元=Thần Tứ kỷ nguyên
星灵帝国=Tinh Linh Đế Quốc
九天玄界=Cửu Thiên Huyền Giới
戮斩矛法=Lục Trảm Mâu Pháp
戮斩三式=Lục Trảm Tam Thức
多重箭雨=Đa Trọng Tiễn Vũ
长月疏影=Trường Nguyệt Sơ Ảnh
"侧闪"="Trắc Thiểm"
时空长舟=Thời Không Trường Chu
深红星坠=Thâm Hồng Tinh Trụy
独目巨人=người khổng lồ một mắt
多重之手=Đa Trọng Chi Thủ
圣号之地=Thánh Hào Chi Địa
亡灵君主=Vong Linh Quân Chủ
北部王国=Bắc Bộ vương quốc
死亡国度=quốc gia Tử Vong
间层世界=Thế Giới Tầng Giữa
圣号之城=Thánh Hào Thành
行空神鸟=Hành Không Thần Điểu
'最上'='Tối Thượng'
日活体验=Nhật Hoạt Thể Nghiệm
圣城之矛=Thánh Thành Chi Mâu
灵念之手=Linh Niệm Chi Thủ
鹊桥归路=Thước Kiều Quy Lộ
倒因为果=Đảo Nhân Thành Quả
圣行之墙=Thánh Hành Tường
火烧连城=Hỏa Thiêu Liên Thành
青云剑圣=Thanh Vân Kiếm Thánh
试炼战场=Thí Luyện Chiến Trường
东城医院=bệnh viện Đông Thành
301室=phòng 301
月下鹿行=Nguyệt Hạ Lộc Hành
幽暗低语=Lời Thì Thầm U Tối
自然法主=Tự Nhiên Pháp Chủ
6. 9=6.9
寂静教会=Yên Tĩnh Giáo Hội
99VS=99VS
三晋沈家=Tam Tấn Thẩm Gia
葡萄糖酸=axit gluconic
破马可死=rồ mát
幽灵骑士=U Linh Kỵ Sĩ
玫瑰之棘=Mai Khôi Chi Cức
黑暗龙城=Hắc Ám Long Thành
尤德里娅=Udria
血魔恶咒=Huyết Ma Ác Chú
双头蛇魔=Song Đầu Xà Ma
白骨之拥=Bạch Cốt Ủng
时间流体=Thời Gian Lưu Thể
塔罗之塔=Tháp Tarot
南宫思睿=Nam Cung Tư Duệ
东南八省=Đông Nam Bát tỉnh
一字冲拳=Nhất Tự Xung Quyền
雷掌要诀=Lôi Chưởng Yếu Quyết
霜月震天=Sương Nguyệt Chấn Thiên
噩梦世界=ác mộng thế giới
月下神照=Nguyệt Hạ Thần Chiếu
噬天嘴法=Phệ Thiên Chủy Pháp
孤独八剑=Cô Độc Bát Kiếm
北东神拳=Bắc Đông Thần Quyền
北东拳法=Bắc Đông Quyền Pháp
南琼黄金=Nam Quỳnh Hoàng Kim
山河天眼=Sơn Hà Thiên Nhãn
鬼火机车=xe máy Quỷ Hỏa
千真万圣=Thiên Chân Vạn Thánh
燃烛之火=lửa đốt nến
机动战甲=Cơ Động Chiến Giáp
灾祸之骷=Tai Họa Chi Khô
浮空岛屿=Phù Không Đảo Nhỏ
悲鸣之潮=Than Khóc Triều
邪舞之神=Tà Vũ Chi Thần
星期先生=Tinh Kỳ tiên sinh
神圣之锹=Xẻng Thần Thánh
榜一大哥=Bảng Nhất Đại Ca
圣藏之戒=Thánh Tàng Giới
苦修之碗=Bát Khổ Tu
明暗神教=Minh Ám Thần Giáo
术法师=Thuật Pháp Sư
谢道灵=Tạ Đạo Linh
宁神香=Ninh Thần Hương
洞天环=Động Thiên Hoàn
召灵棍=Triệu Linh Côn
召灵师=Triệu Linh Sư
玄水门=Huyền Thủy Môn
黄二郎=Hoàng Nhị Lang
碧水峰=Bích Thủy Phong
古霞峰=Cổ Hà Phong
灵应峰=Linh Ứng Phong
栖云峰=Tê Vân Phong
苍鹤峰=Thương Hạc Phong
太上族=Thái Thượng Tộc
七炫光=Thất Huyễn Quang
蝶影术=Điệp Ảnh Thuật
焚炎魔=Phần Viêm Ma
摩高根=Ma Cao Căn
精灵神=Tinh Linh Thần
蛇首鞭=Xà Thủ Tiên
谢孤鸿=Tạ Cô Hồng
传讯符=Truyền Tấn Phù
化蝶级=Hóa Điệp Cấp
原基级=Nguyên Cơ Cấp
韩敬之=Hàn Kính Chi
顾倾城=Cố Khuynh Thành
虚无神=Hư Vô Thần
青毛兽=Thanh Mao Thú
无定山=Vô Định Sơn
黄金犼=Hoàng Kim Hống
小山主=Tiểu Sơn Chủ
破茧级=Phá Kiển Cấp
九御宫=Cửu Ngự Cung
度神城=Độ Thần Thành
圣麒麟=Thánh Kỳ Lân
洛峰主=Lạc Phong Chủ
妙音峰=Diệu Âm Phong
百花殿=Bách Hoa Điện
灵山市=Linh Sơn Thị
多莱克=Doleck
二皇叔=Nhị Hoàng Thúc
张小云=Trương Tiểu Vân
古灵龟=Cổ Linh Quy
皇甫静=Hoàng Phủ Tĩnh
花神族=Hoa Thần Tộc
邪情帝=Tà Tình Đế
小金金=Tiểu Kim Kim
古水神=Cổ Thủy Thần
明水域=Minh Thủy Vực
月之门=Nguyệt Chi Môn
女鬼王=Nữ Quỷ Vương
困魔索=Khốn Ma Tác
潮音剑=Triều Âm Kiếm
顾鬼王=Cố Quỷ Vương
归虚鞘=Quy Hư Sao
南古地=Nam Cổ Địa
骨为鞘=Cốt Vi Sao
唐真流=Đường Chân Lưu
瑞贝特=Thụy Bối Đặc
魂收脚=Hồn Thu Cước
能量炮=Năng Lượng Pháo
陆行龟=Lục Hành Quy
赤阳蝎=Xích Dương Hạt
藤天萝=Đằng Thiên La
娜姆族=Namu Tộc
破坏级=Phá Phôi Cấp
放灵诀=Phóng Linh Quyết
阴暗山=Âm Ám Sơn
法则线=Pháp Tắc Tuyến
见空境=Kiến Không Cảnh
非天经=Phi Thiên Kinh
血命教=Huyết Mệnh Giáo
镇天宫=Trấn Thiên Cung
李可儿=Lý Khả Nhi
神游术=Thần Du Thuật
札斯曼=Zasman
尼尔鲁=Neil
于洋涛=Vu Dương Đào
薛兴福=Tiết Hưng Phúc
火龙术=Hỏa Long Thuật
风助术=Phong Trợ Thuật
大剑仙=Đại Kiếm Tiên
栖魔鱼=Tê Ma Ngư
食人魔=Ogre
神之死=Thần Chi Tử
0 强=0 Cường
古祭神=Cổ Tế Thần
张玄道=Trương Huyền Đạo
存钱术=Tồn Tiễn Thuật
天神冠=Thiên Thần Quan
毁灭级=Hủy Diệt Cấp
天命塔=Thiên Mệnh Tháp
神王殿=Thần Vương Điện
荒古族=Hoang Cổ Tộc
神秘侧=trường phái Thần Bí
蛮荒侧=Man Hoang Trắc
邪灵侧=Tà Linh Trắc
虚无侧=Hư Vô Trắc
赵无踪=Triệu Vô Tung
金焰神=Kim Diễm Thần
控物诀=Khống Vật Quyết
我佛族=Ngã Phật Tộc
虎牙刀=Hổ Nha Đao
游寻境=Du Tầm Cảnh
泯灭弹=Mẫn Diệt Đạn
风骑士=Phong Kỵ Sĩ
烈阳式=Liệt Dương Thức
分裂体=Phân Liệt Thể
秦小楼=Tần Tiểu Lâu
白布衣=Bạch Bố Y
百灯明=Bách Đăng Minh
玉无暇=Ngọc Vô Hạ
破镜丹=Phá Kính Đan
灵果酒=Linh Quả Tửu
灭世者=Diệt Thế Giả
叶飞离=Diệp Phi Ly
白万界=Bạch Vạn Giới
白凌霜=Bạch Lăng Sương
十皇姐=Thập Hoàng Tỷ
异灵真=Dị Linh Chân
白无常=Bạch Vô Thường
光形神=Quang Hình Thần
斩首剑=Trảm Thủ Kiếm
虎神鹰=Hổ Thần Ưng
星辰珠=Tinh Thần Châu
白无上=Bạch Vô Thượng
海魔兽=Hải Ma Thú
估价师=Cổ Giới Sư
玉无瑕=Ngọc Vô Hà
判决者=Phán Quyết Giả
大洪流=Đại Hồng Lưu
大宇宙=Đại Vũ Trụ
木须地=Mộc Tu Địa
哈哈遥=Cáp Cáp Diêu
滑铁卢=Waterloo
藏匿术=Tàng Nặc Thuật
行龙铠=Hành Long Khải
洛加星=Lạc Gia Tinh
垃圾海=Lạp Ngập Hải
大金鱼=Đại Kim Ngư
小金鱼=Tiểu Kim Ngư
洞玄经=Động Huyền Kinh
明澈峰=Minh Triệt Phong
名师堂=Danh Sư Đường
冯子轶=Phùng Tử Dật
张无痕=Trương Vô Ngân
冰原宫=Băng Nguyên Cung
修罗宫=Tu La Cung
苏雪儿=Tô Tuyết Nhi
肉须人=Nhục Tu Nhân
天地钟=Thiên Địa Chung
天下刀=Thiên Hạ Đao
月影神=Nguyệt Ảnh Thần
鸦天狗=Nha Thiên Cẩu
九千帝=Cửu Thiên Đế
邪天狗=Tà Thiên Cẩu
张英豪=Trương Anh Hào
翠丝特=Triste
织命者=Chức Mệnh Giả
阳云生=Dương Vân Sinh
光明灯=Quang Minh Đăng
冷光剑=Lãnh Quang Kiếm
九眼剑=Cửu Nhãn Kiếm
黑甲虫=Hắc Giáp Trùng
韩雨妃=Hàn Vũ Phi
时间系=Thời Gian Hệ
断水流=Đoạn Thủy Lưu
轮空境=Luân Không Cảnh
定命碑=Định Mệnh Bi
狗头人=Cẩu Đầu Nhân
炼尸宗=Luyện Thi Tông
东范市=Đông Phạm Thị
天命镜=Thiên Mệnh Kính
媚神锏=Mị Thần Giản
传奇阶=Truyện Kỳ Giai
无眼兽=Vô Nhãn Thú
金发吼=Kim Phát Hống
上族灯=Thượng Tộc Đăng
刹那神=Sát Na Thần
无界神=Vô Giới Thần
那伽娜=Nagana
结界型=Kết Giới Hình
刻之神=Khắc Chi Thần
蛛千手=Chu Thiên Thủ
空斩刀=Không Trảm Đao
天魔龙=Thiên Ma Long
奇诡侧=Kỳ Quỷ Trắc
夸塞魔=Khoa Tắc Ma
狡诈魔=Giảo Trá Ma
狂暴魔=Cuồng Bạo Ma
善战者=Thiện Chiến Giả
奇异区=Kỳ Dị Khu
争霸区=Tranh Bá Khu
伊丽娅=Yilia
九翅蝉=Cửu Sí Thiền
史诗阶=Sử Thi Giai
罪恶者=Tội Ác Giả
夺心魔=Mind Flayer
读心魔=Độc Tâm Ma
戮天神=Lục Thiên Thần
c23=C23
七魔神=Thất Ma Thần
熊地精=Bugbear
苏流水=Tô Lưu Thủy
风之匙=Phong Chi Chìa Khóa
财神印=Tài Thần Ấn
光荫剪=Quang Ấm Tiễn
戮天锤=Lục Thiên Chuy
冷凝星=Lãnh Ngưng Tinh
百炼尸=Bách Luyện Thi
火丫头=Hỏa nha đầu
胎神镬=Thai Thần Vạc
古灵种=Cổ Linh Chủng
地心炎=Địa Tâm Viêm
古原神=Cổ Nguyên Thần
古铁神=Cổ Thiết Thần
玄黄经=Huyền Hoàng Kinh
杀人鬼=Sát Nhân Quỷ
吃人鬼=Cật Nhân Quỷ
永生者=Vĩnh Sinh Giả
四圣柱=Tứ Thánh Trụ
布灵登=Bố Linh Đăng
议会长=Nghị Hội Trưởng
登石城=Đăng Thạch Thành
小魔鬼=Tiểu Ma Quỷ
李长安=Lý Trường An
王红刀=Vương Hồng Đao
千山夜=Thiên Sơn Dạ
血龙归=Huyết Long Quy
蒙大人=Mông đại nhân
杨夫子=Dương Phu Tử
丘大人=Khâu đại nhân
苏沉舟=Tô Trầm Chu
入魔者=Nhập Ma Giả
沦陷区=Luân Hãm Khu
蛇蝎魔=Xà Hạt Ma
贝利卡=Belika
霸王虫=Bá Vương Trùng
引物诀=Dẫn Vật Quyết
传奇者=Truyền Kỳ Giả
角之冠=Giác Chi Quan
伊贝克=Ibeck
阿斯卡=Aska
永食魔=Vĩnh Thực Ma
古今井=Cổ Kim Giếng
马国臣=Mã Quốc Thần
奇美拉=Chimera
修行侧=trường phái Tu Hành
莫耐斯=Mones
荆棘鸟=Kinh Cức Điểu
集骨者=Tập Cốt Giả
青铜阶=Thanh Đồng Giai
深渊海=Thâm Uyên Hải
大神山=Đại Thần Sơn
风翼蛇=Phong Dực Xà
暴风虎=Bạo Phong Hổ
赵爵爷=Triệu Tước Gia
血魅灵=Huyết Mị Linh
李三眼=Lý Tam Nhãn
玉狮王=Ngọc Sư Vương
圣安术=Thánh An Thuật
神术师=Thần Thuật Sư
玉狮谷=Ngọc Sư Cốc
独天蛟=Độc Thiên Giao
鬼罗刹=Quỷ La Sát
黑晶体=Hắc Tinh Thể
黑晶石=Hắc Tinh Thạch
再来人=Tái Lai Nhân
散布者=Tán Bố Giả
地狱海=Địa Ngục Hải
秦州长=Tần Châu Trưởng
长佟央=Trường Đông Ương
哭婴灵=Khốc Anh Linh
魔鬼山=Ma Quỷ Sơn
于经理=Vu Kinh Lý
弑龙者=Thí Long Giả
预见牌=Dự Kiến Bài
清洁术=Thanh Khiết Thuật
南十字=Nam Thập Tự
岩石人=Nham Thạch Nhân
张宗阳=Trương Tông Dương
李冰语=Lý Băng Ngữ
时间流=dòng chảy thời gian
因果侧=Nhân Quả Trắc
维克那=Wickner
剑不孤=Kiếm Bất Cô
啃噬者=Khẳng Phệ Giả
魂琢刀=Hồn Trác Đao
落日桥=Lạc Nhật Kiều
天选技=Thiên Tuyển Kỹ
卢小铂=Lô Tiểu Bạc
混乱者=Hỗn Loạn Giả
割火者=Cát Hỏa Giả
方七愿=Phương Thất Nguyện
迷诱魔=Mê Dụ Ma
安魂乡=An Hồn Hương
玉璧城=Ngọc Bích Thành
灵眼妖=Linh Nhãn Yêu
八音虫=Bát Âm Trùng
千百身=Thiên Bách Thân
次元门=Thứ Nguyên Môn
贴身甲=Thiếp Thân Giáp
夜之歌=Dạ Chi Ca
小冲锋=Tiểu Súng Ngắn
唤潮者=Hoán Triều Giả
赵山河=Triệu Sơn Hà
瀚海市=Hãn Hải Thị
江慕白=Giang Mộ Bạch
姜明生=Khương Minh Sinh
姜小凰=Khương Tiểu Hoàng
夜哭谷=Dạ Khốc Cốc
霜巨人=Sương Cự Nhân
苍雨派=Thương Vũ Phái
姚无期=Diêu Vô Kỳ
邀请者=Yêu Thỉnh Giả
净念诀=Tịnh Niệm Quyết
破魂斩=Phá Hồn Trảm
命运侧=Vận Mệnh Trắc
苍生引=Thương Sinh Dẫn
日月遮=Nhật Nguyệt Già
飞驰者=Phi Trì Giả
超时空=Siêu Thời Không
四柱之=Tứ Trụ
万物石=Vạn Vật Thạch
大鬼将=Đại Quỷ Tướng
杀虫剂=thuốc sát trùng
白银萌=Bạch Ngân Manh
鬼器灵=Quỷ Khí Linh
凤菲菲=Phượng Phỉ Phỉ
公叔谨=Công Thúc Cẩn
古亚星=Cổ Á Tinh
娄九眼=Lâu Cửu Nhãn
食脏虫=Thực Tạng Trùng
灯草虫=Đăng Thảo Trùng
请神符=Thỉnh Thần Phù
忘川江=Vong Xuyên Giang
魔罗天=Ma La Thiên
龙前泪=Long Tiền Lệ
睺多罗=Hầu Đa La
祭之舞=Tế Vũ
马头刀=Mã Đầu Đao
云海界=Vân Hải Giới
白银盟=Bạch Ngân Minh
通天柱=Thông Thiên Trụ
主祭者=Chủ Tế Giả
青冥丹=Thanh Minh Đan
张永治=Trương Vĩnh Trì
王雅韵=Vương Nhã Vận
常遇礼=Thường Ngộ Lễ
上散将=Thượng Tán Tướng
九连击=Cửu Liên Kích
十燕归=Thập Yến Quy
大天鬼=Đại Thiên Quỷ
须弥山=Tu Di Sơn
火毁剑=Hỏa Hủy Kiếm
镜千尺=Kính Thiên Xích
苍无彰=Thương Vô Chương
橘之山=Quất Chi Sơn
雨雄主=Vũ Hùng Chủ
"雨"="Vũ"
霜之翼=Sương Chi Dực
纯光螈=Thuần Quang Nguyên
夏雨飞=Hạ Vũ Phi
大天魔=Đại Thiên Ma
龙血泉=Long Huyết Tuyền
断罪者=Đoạn Tội Giả
里世界=thế giới bên trong
柏国诚=Bách Quốc Thành
东八区=Đông Bát Khu
康宏站=Khang Hoành Trạm
公叔止=Công Thúc Chỉ
血神龙=Huyết Thần Long
李大骏=Lý Đại Tuấn
余秋白=Dư Thu Bạch
元气诀=Nguyên Khí Quyết
大力蚁=Đại Lực Nghĩ
伴生宠=phối hợp sủng
方若惜=Phương Nhược Tích
田向东=Điền Hướng Đông
雷霆功=Lôi Đình Công
周凌风=Chu Lăng Phong
欧阳蓝=Âu Dương Lam
伴生卵=phối hợp trứng
安天佐=An Thiên Tá
归德府=Quy Đức Phủ
枯骨掌=Khô Cốt Chưởng
徐绵图=Từ Miên Đồ
暴鳞蛇=Bạo Lân Xà
射日诀=Xạ Nhật Quyết
井道仙=Tỉnh Đạo Tiên
迷仙经=Mê Tiên Kinh
乔思远=Kiều Tư Viễn
灰烬掌=Hôi Tẫn Chưởng
钢羽隼=Cương Vũ Chuẩn
夜如曦=Dạ Như Hi
夜若曦=Dạ Như Hi
破甲枪=Phá Giáp Thương
李未央=Lý Vị Ương
古战马=Cổ Chiến Mã
夜将军=Dạ tướng quân
未央姐=Vị Ương tỷ
李末央=Lý Mạt Ương
刺猬功=Thứ Vị Công
金雕王=Kim Điêu Vương
夜行人=Dạ Hành Nhân
青铜殿=Thanh Đồng Điện
虚空侧=Hư Không Trắc
梦境级=Mộng Cảnh Cấp
天之碎=Thiên Toái
地之葬=Địa Táng
祭之献=Tế Hiến
小李子=Tiểu Lý Tử
兽深窟=Thú Thâm Quật
东荒窟=Đông Hoang Quật
李三郎=Lý Tam Lang
李山狼=Lý Sơn Lang
李秋山=Lý Thu Sơn
李秋雨=Lý Thu Vũ
听风者=Thính Phong Giả
李春刀=Lý Xuân Đao
修习社=Tu Tập Xã
典藏长=Điển Tàng Trưởng
许扬君=Hứa Dương Quân
开拓境=Khai Thác Cảnh
天宗境=Thiên Tông Cảnh
帝王境=Đế Vương Cảnh
明尊境=Minh Tôn Cảnh
四圣宫=Tứ Thánh Cung
玉珠峰=Ngọc Châu Phong
青龙刀=Thanh Long Đao
朱雀旗=Chu Tước Kỳ
白虎锤=Bạch Hổ Chùy
爆天锤=Bạo Thiên Chùy
炼宇术=Luyện Vũ Thuật
谪剑仙=Trích Kiếm Tiên
兽王道=Thú Vương Đạo
日游神=Nhật Du Thần
兵器使=Binh Khí Sử
张九白=Trương Cửu Bạch
徐幽海=Từ U Hải
主祭司=Chủ Tế Tự
古祭铜=Cổ Tế Đồng
雷狮骑=Lôi Sư Kỵ
凤大家=Phượng đại gia
鲁三直=Lỗ Tam Trực
都天玉=Đô Thiên Ngọc
玉壁城=Ngọc Bích Thành
虚空城=Hư Không Thành
蛤蟆怪=Cáp Mô Quái
深渊城=Thâm Uyên Thành
范德萨=Phạm Đức Tát
山之傀=Sơn Khôi
凶魔塔=Hung Ma Tháp
制卡师=Chế Tạp Sư
能量卡=thẻ năng lượng
刻光盘=Khắc Quang Bàn
流影步=Lưu Ảnh Bộ
留影步=Lưu Ảnh Bộ
幽天鬼=U Thiên Quỷ
苍雄主=Thương Hùng Chủ
天都市=Thiên Đô thị
剑卡师=Kiếm Tạp Sư
孙跑跑=Tôn Bào Bào
小小白=Tiểu Tiểu Bạch
小小剑=Tiểu Tiểu Kiếm
李昊然=Lý Hạo Nhiên
小小鸡=Tiểu Tiểu Kê
清明市=Thanh Minh thị
制卡笔=Bút Chế Thẻ
小陆鸣=Tiểu Lục Minh
幻境师=Huyễn Cảnh Sư
留声石=Lưu Thanh Thạch
明凉府=Minh Lương Phủ
江阳镇=Giang Dương Trấn
刘德武=Lưu Đức Võ
刘三火=Lưu Tam Hỏa
刘文才=Lưu Văn Tài
佛骨功=Phật Cốt Công
测赋玉=Trắc Phú Ngọc
庞苍雷=Bàng Thương Lôi
蒙头领=Mông đầu lĩnh
炼体境=Luyện Thể Cảnh
蒙冲山=Mông Trùng Sơn
聂天宁=Niếp Thiên Ninh
淬骨境=Thối Cốt Cảnh
赤火盗=Xích Hỏa Đạo
徐铉海=Từ Huyễn Hải
陨星门=Vẫn Tinh Môn
虎狼丹=Hổ Lang Đan
风霜草=Phong Sương Thảo
昌一铭=Xương Nhất Minh
支配级=Chi Phối Cấp
冰雪城=Băng Tuyết Thành
虚空洞=Hư Không Động
兰卢郡=Lan Lô Quận
铁鬓猪=Thiết Tấn Trư
棕毛兽=Tông Mao Thú
炼狱狼=Luyện Ngục Lang
青空斩=Thanh Không Trảm
混乱侧=Hỗn Loạn Trắc
万符阵=Vạn Phù Trận
卷轴师=Quyển Trục Sư
灭魂山=Diệt Hồn Sơn
黄潜九=Hoàng Tiềm Cửu
积分试=Thi Điểm Tích Lũy
预言侧=Tiên Đoán Trắc
洪义孓=Hồng Nghĩa Quyết
蹈红尘=Đạo Hồng Trần
时之技=Thời Gian Kỹ Năng
昆仑城=Côn Luân Thành
赵小僧=Triệu Tiểu Tăng
恶鬼道=Ác Quỷ Đạo
命运技=vận mệnh kỹ năng
'因'='Nhân'
'果'='Quả'
藏匿者=Người Ẩn Náu
万神殿=Vạn Thần Điện
霜刀虎=Sương Đao Hổ
齿轮堡=Bánh Răng Bảo
百武城=Bách Võ Thành
黑火山=Hắc Hỏa Sơn
秦甫沅=Tần Phủ Nguyên
光之隐=Quang Ẩn
拾荒站=trạm nhặt ve chai
拾荒场=Bãi Nhặt Ve Chai
翠斯特=Triste
克萝托=Krotto
次神技=Thứ Thần Kỹ
生死河=Sinh Tử Hà
丁北图=Đinh Bắc Đồ
层岩市=Tầng Nham Thị
王路峰=Vương Lộ Phong
外卖服=trang phục giao hàng
熊泰光=Hùng Thái Quang
奋斗南=Phấn Đấu Nam
苏健军=Tô Kiện Quân
苏健州=Tô Kiện Châu
侦捕局=Trinh Bộ Cục
仁青省=Nhân Thanh Tỉnh
苏青封=Tô Thanh Phong
王南国=Vương Nam Quốc
李星佩=Lý Tinh Bội
星辰法=Tinh Thần Pháp
公孙智=Công Tôn Trí
被杀者=kẻ bị giết
澜江兄=Lan Giang huynh
动极尬=Động Cực Giới
许星薇=Hứa Tinh Vi
app=App
谢飞机=Tạ Phi Cơ
追光者=Truy Quang Giả
充能站=Trạm Sung Năng
焚化员=Hỏa Táng Viên
齐城市=Tề Thành Thị
死亡河=Tử Vong Hà
萨法娅=Sayfasia
瓶咒师=Bình Chú Sư
哈库鲁=Hakuru
田园犬=chó bản địa
沙人类=Sa Nhân Loại
石常磊=Thạch Thường Lỗi
龙涎水=Long Tiên Thủy
龙本咒=Long Bản Chú
红龙咒=Công Long Chú
英灵殿=Anh Linh Điện
巨齿鳄=Cự Xỉ Ngạc
梦想岛=Mộng Tưởng Đảo
女魔人=Nữ Ma Nhân
赵有邦=Triệu Hữu Bang
赵友邦=Triệu Hữu Bang
夜雨弓=Dạ Vũ Cung
山之魁=Sơn Khôi
山之拳=Sơn Quyền
仙武界=Tiên Võ Giới
宁刀圣=Ninh Đao Thánh
顾道友=Cố đạo hữu
风闻录=Phong Văn Lục
沙九藏=Sa Cửu Tàng
齐声道=đồng loạt nói
人物的=nhân vật
赵九轩=Triệu Cửu Hiên
冷千尘=Lãnh Thiên Trần
魔罗弓=Ma La Cung
等待者=Người Chờ Đợi
蹦嚓嚓=xoạt xoạt xoạt
莫测境=Khó Lường Cảnh
假死者=Người Giả Chết
相位界=Tướng Vị Giới
翼王兽=Dực Vương Thú
江之斩=Giang Trảm
西塔尔=Sitar
廖小炮=Liêu Tiểu Pháo
尿小泡=Niệu Tiểu Phao
顾萝拉=Cố Laura
跳火环=nhảy vòng lửa
穿插舞=múa luân phiên
天元王=Thiên Nguyên Vương
神乱会=Thần Loạn Hội
贾太傅=Cổ Thái Phó
贾似真=Cổ Tự Chân
凤音音=Phượng Âm Âm
洛基德=Lạc Cơ Đức
基因师=Gien Sư
小飞鱼=Tiểu Phi Ngư
不为井=Bất Vi Tỉnh
燕北飞=Yến Bắc Phi
卓东来=Trác Đông Lai
小径诡=Tiểu Kính Quỷ
六道的=Lục Đạo
张村守=Trương thôn thủ
顾巡守=Cố tuần thủ
镇武卫=Trấn Võ Vệ
青羊镇=Thanh Dương Trấn
程千山=Trình Thiên Sơn
掌令使=Chưởng Lệnh Sứ
均富卡=Thẻ Quân Phú
淬元境=Thối Nguyên Cảnh
收了弓=thu cung
九坪镇=Cửu Bình Trấn
纯爱组=Thuần Yêu Tổ
飞离,=Phi Ly,
火魔蛇=Hỏa Ma Xà
万魔遮=Vạn Ma Già
人间道=Nhân Gian Đạo
九连城=Cửu Liên Thành
噬仙蛊=Phệ Tiên Cổ
追魂粉=Truy Hồn Phấn
天魔曲=Thiên Ma Khúc
八珍楼=Bát Trân Lâu
恶鬼界=Ác Quỷ Giới
天之法=Thiên Pháp
天魔女=Thiên Ma Nữ
音之狱=Âm Ngục
功德石=Công Đức Thạch
林大海=Lâm Đại Hải
6 道=Lục Đạo
星河城=Tinh Hà Thành
座墓岛=tòa mộ đảo
这它娘=mẹ nó đây
魔法网=mạng lưới Ma Pháp
摧灭拳=Thôi Diệt Quyền
伤火环=Thương Hỏa Hoàn
钟妙音=Chung Diệu Âm
基因技=Gien Kỹ
神言王=Thần Ngôn Vương
野之苹=táo ngoài đồng
轮回殿=Luân Hồi Điện
化生池=Hóa Sinh Trì
地狱部=Địa Ngục Bộ
属水狗=thuộc rái cá
怀仙馆=Hoài Tiên Quán
三七一=371
操控师=Thầy Điều Khiển
甲字号=hiệu chữ Giáp (甲)
千重殿=Thiên Trọng Điện
而不撑=mà không no
顾黑龙=Cố Hắc Long
轮回界=Luân Hồi Giới
张九九=Trương Cửu Cửu
魔法侧=Ma Pháp Trắc
武道侧=Võ Đạo Trắc
羽族长=Vũ tộc trưởng
三颗星=Ba viên ngôi sao
时之屏=Thời Chi Bình
神眷侧=Thần Quyến Trắc
顾魔虫=Cố Ma Trùng
山妩媚=Sơn Vũ Mị
长一切=sinh trưởng hết thảy
储物格=Ô Trữ Vật
事件线=dây sự kiện
江东流=Giang Đông Lưu
夺念者=Kẻ Đoạt Niệm
4 柱=Tứ Trụ
临界点=Điểm giới hạn
地与水=Địa cùng Thủy
卡牌侧=Thẻ Bài Trắc
苍无魔=Thương Vô Ma
转轮者=Chuyển Luân Giả
食龙者=Thực Long Giả
景真帝=Cảnh Chân Đế
天命井=Thiên Mệnh Giếng
的是,=chính là,
凡尘天=Phàm Trần Thiên
葬道天=Táng Đạo Thiên
避尘珠=Tị Trần Châu
金毛犼=Kim Mao Hống
暗王庭=Ám Vương Đình
之水神=Thủy Thần
君长别=quân trưởng chia ly
三十兆=ba mươi nghìn tỷ
荒云宫=Hoang Vân Cung
之道路=Đạo Lộ
雷光拳=Lôi Quang Quyền
时间点=Thời Gian Điểm
屠龙者=Đồ Long Giả
傀儡星=Khôi Lỗi Tinh
于将军=Vu tướng quân
维森莫=Wissenmore
拉莫帅=Ramoshuai
沃德天=Ward
梅迪契=Medici
瓦罗娜=Varona
灰烬海=Biển Tro Tàn
3 术=Tam Thuật
守幕者=Thủ Mạc Giả
星辰系=Tinh Thần Hệ
玉麒麟=Ngọc Kỳ Lân
赤焰狮=Xích Diễm Sư
曾师弟=Tăng sư đệ
地脉师=Địa Mạch Sư
玄牝宗=Huyền Tẫn Tông
赵凝儿=Triệu Ngưng Nhi
顾苏安=Cố Tô An
轮回术=Luân Hồi Thuật
玄天衣=Huyền Thiên Y
仇老哥=Cừu lão ca
红袖楼=Hồng Tụ Lâu
无极卵=Vô Cực Trứng
破界兽=Phá Giới Thú
赵秋意=Triệu Thu Ý
分界石=Phân Giới Thạch
邪魔道=Tà Ma nói
大铁围=Đại Thiết Vi
轮回路=Luân Hồi Lộ
追圣台=Truy Thánh Đài
凤头琴=Phượng Đầu Cầm
破界级=Phá Giới cấp
林长风=Lâm Trường Phong
入门试=Thi Nhập Môn
万音宗=Vạn Âm Tông
聂子铮=Nhiếp Tử Tranh
吸灵阵=Hấp Linh Trận
依山尽=Y Sơn Tận
白子柔=Bạch Tử Nhu
利刃天=Lợi Nhận Thiên
基因碑=Gien Bia
投胎机=Đầu Thai Cơ
影之舞=Ảnh Vũ
顾舒安=Cố Thư An
饮血魔=Ẩm Huyết Ma
军备室=Quân Bị Thất
意识层=ý thức tầng
冷天星=Lãnh Thiên Tinh
千骑剑=Thiên Kỵ Kiếm
食腐妖=Thực Hủ Yêu
何浩劫=Hà Hạo Kiếp
宁圣女=Ninh thánh nữ
广寒珠=Nghiễm Hàn Châu
冯霍德=Phùng Hoắc Đức
战天使=Chiến Thiên Sứ
谢霜颜=Tạ Sương Nhan
广阳门=Nghiễm Dương Môn
暗五行=Ám Ngũ Hành
贫龙窟=Bần Long Quật (Hang Rồng Nghèo)
大不祥=đại điềm xấu
点羽数=Điểm Vũ Số
碟片机=máy CD
赖皮王=Vô Lại Vương
天与地=Thiên cùng Địa
五条悟=Ngũ Điều Ngộ
独孤琼=Độc Cô Quỳnh
小潮音=Tiểu Triều Âm
时光海=Biển Thời Gian
烟横杠=Yên Hoành Giang
霜天使=Sương thiên sứ
烟火的=Yên Hỏa
天圣者=Thiên Thánh Giả
回生散=Hồi Sinh Tán
鲁云门=Lỗ Vân Môn
陈双羽=Trần Song Vũ
控鹤丹=Khống Hạc Đan
命魂殿=Mệnh Hồn Điện
邪修谷=Tà Tu Cốc
隐杀楼=Ẩn Sát Lâu
赵婵衣=Triệu Thiền Y
黎道友=Lê đạo hữu
赵蝉衣=Triệu Thiền Y
灵犬符=Linh Khuyển Phù
独角马=Độc Giác Mã
兰草谷=Lan Thảo Cốc
暗雾镇=Ám Vụ trấn
青宁子=Thanh Ninh Tử
受术者=kẻ nhận thuật
9 幽=Cửu U
留影阵=Lưu Ảnh Trận
侧术法=Trắc Thuật Pháp
卡牌师=Thẻ Bài Sư
卡拉度=Karadu
回归卡=Hồi Quy Thẻ
百生门=Bách Sinh Môn
滥赌鬼=Lạm Đổ Quỷ
第三幕=màn thứ ba
太微宫=Thái Vi Cung
神光宗=Thần Quang Tông
天音阁=Thiên Âm Các
青冥门=Thanh Minh Môn
伏魔谷=Phục Ma Cốc
潇湘派=Tiêu Tương Phái
纳物符=Nạp Vật Phù
聚灵符=Tụ Linh Phù
傀儡符=Khôi Lỗi Phù
时空锚=Thời Không Mỏ Neo
谢东流=Tạ Đông Lưu
追踪者=Kẻ Theo Dõi
吞魔石=Thôn Ma Thạch
空白符=Không Bạch Phù
借法符=Tá Pháp Phù
魂无心=Hồn Vô Tâm
神秘技=Thần Bí Kỹ Năng
初演者=Kẻ Sơ Diễn
霜铁镇=Sương Thiết trấn
隔空斩=Cách Không Trảm
色之衣=Sắc Y
寻物诀=Tầm Vật Quyết
双情劫=Song Tình Kiếp
李长雪=Lý Trường Tuyết
金丹劫=Kim Đan Kiếp
捕灵者=Kẻ Bắt Linh
误入者=Kẻ Ngộ Nhập
神照境=Thần Chiếu cảnh
虚神斩=Hư Thần Trảm
星力侧=Tinh Lực Trắc
灵能侧=Linh Năng Trắc
狱界侧=Ngục Giới Trắc
隔绝阵=Cách Tuyệt Trận
隐匿阵=Ẩn Nấp Trận
杨朝胜=Dương Triều Thắng
摄物诀=Nhiếp Vật Quyết
封圣境=Phong Thánh Cảnh
C 区=khu C
王主管=Vương chủ quản
家禽卡=thẻ gia cầm
杂物卡=thẻ tạp vật
古武侧=Cổ Võ Trắc
拳术家=Quyền Thuật Gia
秦冰安=Tần Băng An
武天王=Võ Thiên Vương
血骑士=Huyết Kỵ Sĩ
魔王们=các Ma Vương
月之泉=Nguyệt Tuyền
神职者=Thần Chức Giả
小丑卡=thẻ Thằng Hề
星灵侧=trường phái Tinh Linh
治疗卡=Thẻ Trị Liệu
绘画师=Hội Họa Sư
愈命丹=Dũ Mệnh Đan
神力线=Thần Lực Tuyến
沉眠者=Kẻ Ngủ Say
英灵卡=Thẻ Anh Linh
持火者=Kẻ Cầm Lửa
职业卡=Thẻ Nghề Nghiệp
侧力量=trường pháp lực lượng
文大钱=Văn Đại Tiền
命魂卡=Thẻ Mệnh Hồn
燃魂术=Nhiên Hồn Thuật
捕兽夹=Bẫy Kẹp Bắt Thú
星辰级=Tinh Thần cấp
星辰卡=Tinh Thần thẻ
陷阱卡=thẻ bẫy rập
圣者们=bọn Thánh giả
钱武周=Tiền Võ Chu
季白雨=Quý Bạch Vũ
登神战=Đăng Thần Chiến
失魂者=Kẻ Mất Hồn
奇诡卡=kỳ quỷ thẻ
圣吟术=Thánh Ngâm Thuật
治愈者=Người Trị Liệu
回归者=Người Trở Về
骷髅犬=Khô Lâu Khuyển
花晴空=Hoa Tình Không
钱周武=Tiền Chu Võ
灵一侧=phương diện Linh Nhất
唤灵师=Hoán Linh Sư
胜武团=Thắng Võ Đoàn
野蔷薇=Dã Sắc Vi
萧梦萝=Tiêu Mộng La
魔巨人=Ma Cự Nhân
擒月鹰=Cầm Nguyệt Ưng
夜精灵=Dạ Tinh Linh
解题人=Người Giải Đề
保皇党=Bảo Hoàng Đảng
进阶卡=Thẻ Tiến Giai
浮灯路=đường Phù Đăng
雄变雌=Đực Biến Cái
追踪卡=Thẻ Truy Tung
圣餐术=Thánh Xan Thuật
检测卡=Thẻ Kiểm Tra
传令官=Quan Truyền Lệnh
地缚灵=Địa Phược Linh
慕爱珊=Mộ Ái San
张小明=Trương Tiểu Minh
张小宁=Trương Tiểu Ninh
武小德=Vũ Tiểu Đức
夏蕙兰=Hạ Huệ Lan
赵君羽=Triệu Quân Vũ
孙明月=Tôn Minh Nguyệt
赵子昂=Triệu Tử Ngang
·冲劲=·Xung Kình
铁线流=Thiết Tuyến Lưu
长虹街=đường Trường Hồng
建模师=Kiến Mô Sư
萧白红=Tiêu Bạch Hồng
滨江路=đường Tân Giang
职业者=Chức Nghiệp Giả
邪术师=Tà Thuật Sư
亡灵侧=phương diện Vong Linh
傅正阳=Phó Chính Dương
钱明魁=Tiền Minh Khôi
李火旺=Lý Hỏa Vượng
白灵淼=Bạch Linh Miểu
柳宗元=Liễu Tông Nguyên
监天司=Giám Thiên Ti
葛冷山=Cát Lãnh Sơn
钱魁明=Tiền Khôi Minh
赵芷冰=Triệu Chỉ Băng
知情权=biết tình tiết sự kiện quyền
骨手机=điện thoại bằng xương
鬼火斩=Quỷ Hỏa Trảm
吹梦刀=Thổi Mộng Đao
孙术华=Tôn Thuật Hoa
张尔舞=Trương Nhĩ Vũ
白江市=Bạch Giang Thị
李昆仑=Lý Côn Luân
白马村=Bạch Mã Thôn
东五国=Đông Ngũ Quốc
'白'='Bạch'
圣祷术=Thánh Đảo Thuật
雾影者=Vụ Ảnh Giả
雾隐者=Vụ Ẩn Giả
悼亡者=Điệu Vong Giả
烂骨仔=Lạn Cốt Tử
种仙缘=Chủng Tiên Duyên
拆骨术=Sách Cốt Thuật
陆长生=Lục Trường Sinh
贝伦斯=Behrens
赵小裳=Triệu Tiểu Thường
补髓丹=Bổ Tủy Đan
礼貌人=người lễ phép
沈时安=Thẩm Thời An
洛非川=Lạc Phi Xuyên
江汉涛=Giang Hán Đào
陈浩宇=Trần Hạo Vũ
赵以冰=Triệu Dĩ Băng
钱如山=Tiền Như Sơn
钱主管=Tiền chủ quản
沈同学=Thẩm đồng học
王学木=Vương Học Mộc
萧梦鱼=Tiêu Mộng Ngư
五所省=Ngũ Sở tỉnh
幽影术=U Ảnh Thuật
剥皮者=Kẻ Lột Da
人皮术=Thuật Da Người
宋清允=Tống Thanh Doãn
沈硕朋=Thẩm Thạc Bằng
燕秋灵=Yến Thu Linh
死兆星=Tử Triệu Tinh
沈佩奇=Thẩm Peppa
小佩奇=Tiểu Peppa
郭云野=Quách Vân Dã
无星级=Vô Tinh Cấp
张小义=Trương Tiểu Nghĩa
余似海=Dư Tự Hải
浮空岛=Phù Không Đảo
月下系=Nguyệt Hạ hệ
浮空港=Phù Không Cảng
二阳指=Nhị Dương Chỉ
云山港=Vân Sơn cảng
王九炎=Vương Cửu Viêm
赵千钧=Triệu Thiên Quân
苍南焰=Thương Nam Diễm
何西寺=Hà Tây Tự
夜幕剑=Màn Đêm Kiếm
残雪剑=Tàn Tuyết Kiếm
殷听雪=Ân Thính Tuyết
襄王府=Tương Vương phủ
银台寺=Ngân Đài Tự
沈泱=Trầm Ương
黄战=Hoàng Chiến
地剑=Địa Kiếm
赵宽=Triệu Khoan
天界=Thiên Giới
饲园=Tự Viên
龟少=Quy Thiểu
天宫=Thiên Cung
蝶女=Điệp Nữ
邪徽=Tà Huy
神孽=Thần Nghiệt
青山=Thanh Sơn
剑渊=Kiếm Uyên
奥秒=Áo Miểu
原基=Nguyên Cơ
小情=Tiểu Tình
恋蝶=Luyến Điệp
帝夋=Đế Thuân
白皇=Bạch Hoàng
族灯=Tộc Đăng
化蝶=Hóa Điệp
破茧=Phá Kiển
紫斗=Tử Đấu
宝樱=Bảo Anh
金币=Kim Tệ
音宗=Âm Tông
妙音=Diệu Âm
云鹤=Vân Hạc
本峰=Bản Phong
四圣=Tứ Thánh
命神=Mệnh Thần
花城=Hoa Thành
克司=Kesi
山女=Sơn Nữ
龟族=Quy Tộc
灵龟=Linh Quy
天剑=Thiên Kiếm
盗圣=Đạo Thánh
麦塔=Mehta
劣魔=Liệt Ma
天魔=Thiên Ma
牙刀=Nha Đao
乾九=Càn Cửu
乱星=Loạn Tinh
归元=Quy Nguyên
明神=Minh Thần
恐鼠=Khủng Thử
传奇=Truyền Kỳ
娜姆=Namu
天萝=Thiên La
战神=Chiến Thần
极古=Cực Cổ
魔王=Ma Vương
字节=Tự Tiết
魔女=Ma Nữ
联动=Liên Động
死雾=Tử Vụ
乱劫=Loạn Kiếp
震遂=Chấn Toại
玲珑=Linh Lung
楼烈=Lâu Liệt
媚姨=Mị Di
秦烽=Tần Phong
吞天=Thôn Thiên
郭冠=Quách Quan
白璃=Bạch Ly
封圣=Phong Thánh
千劫=Thiên Kiếp
太虚=Thái Hư
炼气=Luyện Khí
筑基=Trúc Cơ
风羽=Phong Vũ
潮音=Triều Âm
燕归=Yến Quy
惊梦=Kinh Mộng
神殇=Thần Thương
绿羽=Lục Vũ
刀力=Đao Lực
力神=Lực Thần
灰卡=Hôi Tạp
翡级=Phỉ Cấp
翡色=Phỉ Sắc
音神=Âm Thần
佛族=Phật Tộc
座狼=Tọa Lang
空轮=Không Luân
上族=Thượng Tộc
孔飞=Khổng Phi
赵六=Triệu Lục
剑星=Kiếm Tinh
铁围=Thiết Vi
红庙=Hồng Miếu
黄庙=Hoàng Miếu
异灵=Dị Linh
金焰=Kim Diễm
火种=Hỏa Chủng
隼鹰=Chuẩn Ưng
锈刃=Tú Nhận
魔钻=Ma Toản
邪歧=Tà Kỳ
灰炎=Hôi Viêm
神化=Thần Hóa
奈落=Naraku
玛特=Mã Đặc
龚宗=Cung Tông
姜胜=Khương Thắng
天劫=Thiên Kiếp
劫火=Kiếp Hỏa
寒冰=Hàn Băng
雅稚=Nhã Trĩ
张悬=Trương Huyền
稚罗=Trĩ La
唯尊=Duy Tôn
石灯=Thạch Đăng
淇歌=Kỳ Ca
犬鸦=Khuyển Nha
月影=Nguyệt Ảnh
革命=Cách Mạng
圣园=Thánh Viên
善功=Thiện Công
水劫=Thủy Kiếp
地劫=Địa Kiếp
秦修=Tần Tu
空魅=Không Mị
赤魁=Xích Khôi
怯魔=Khiếp Ma
灰流=Hôi Lưu
黯紫=Ảm Tử
莱戈=Lai Qua
虫界=Trùng Giới
云宫=Vân Cung
神旗=Thần Kỳ
喜庆=Hỉ Khánh
财神=Tài Thần
狐妃=Hồ Phi
鬼骨=Quỷ Cốt
魔潮=Ma Triều
魔母=Ma Mẫu
人族=Nhân Tộc
荆棘=Kinh Cức
虫皇=Trùng Hoàng
虫帝=Trùng Đế
天抉=Thiên Quyết
地抉=Địa Quyết
宛儿=Uyển Nhi
熊二=Hùng Nhị
布灵=Bố Linh
秦蓝=Tần Lam
小夕=Tiểu Tịch
红伞=Hồng Tán
熊大=Hùng Đại
馥祀=Phức Tự
万渊=Vạn Uyên
卡若=Tạp Nhược
碗面=bát mì
柔术=Nhu Thuật
量劫=Lượng Kiếp
孤竹=Cô Trúc
男魔=Nam Ma
湛蓝=xanh thẳm
晴柔=Tình Nhu
蝎魔=Hạt Ma
猫族=Miêu Tộc
龙歌=Long Ca
深渊=vực sâu
蛇男=Xà Nam
石博=Thạch Bác
岚岫=Lam Tụ
轻音=Khinh Âm
因克=Nhân Khắc
塞音=Tắc Âm
魔枪=Ma Thương
戾龙=Lệ Long
秦白=Tần Bạch
骨龙=Cốt Long
眼魔=Nhãn Ma
剑瞳=Kiếm Đồng
苏铃=Tô Linh
圣能=Thánh Năng
圣恩=Thánh Ân
原星=Nguyên Tinh
石殿=Thạch Điện
骨壁=Cốt Bích
贺佳=Hạ Giai
百爪=Bách Trảo
佟央=Đông Ương
廖行=Liêu Hành
犬神=Khuyển Thần
黑犬=Hắc Khuyển
灵星=Linh Tinh
白墨=Bạch Mặc
秦金=Tần Kim
英豪=Anh Hào
神罚=Thần Phạt
齐焰=Tề Diễm
星冠=Tinh Quan
七神=Thất Thần
泫雅=Huyễn Nhã
弹爷=Đạn Gia
神器=Thần Khí
神只=Thần Chích
秦墨=Tần Mặc
韩瑶=Hàn Dao
林霄=Lâm Tiêu
枪武=Thương Võ
死神=Tử Thần
四神=Tứ Thần
德努=Đức Nỗ
灰狗=Hôi Cẩu
霜锋=Sương Phong
神龙=Thần Long
织王=Chức Vương
迁跃=Thiên Dược
火神=Hỏa Thần
影击=Ảnh Kích
古炎=Cổ Viêm
傻强=Sỏa Cường
兰塔=Lan Tháp
娄九=Lâu Cửu
圣咏=Thánh Vịnh
腾夜=Đằng Dạ
雷影=Lôi Ảnh
祈神=Kỳ Thần
鹤掌=Hạc Chưởng
崔姓=Thôi Tính
白龙=Bạch Long
夜摩=Dạ Ma
面咒=Diện Chú
金筷=đũa vàng
召魂=Triệu Hồn
小楼=Tiểu Lâu
山神=Sơn Thần
道诀=Đạo Quyết
天柱=Thiên Trụ
黄龙=Hoàng Long
龙咆=Long Bào
法锣=Pháp Chiêng
名格=Danh Cách
白灼=Bạch Chước
橘矛=Quất Mâu
镇邪=Trấn Tà
妖凤=Yêu Phượng
橘隐=Quất Ẩn
橘影=Quất Ảnh
山爷=Sơn gia
天崩=Thiên Băng
鬼主=Quỷ Chúa
魔狗=Ma Cẩu
口实=mượn cớ
雨雄=Vũ Hùng
功劳=công lao
百怨=Bách Oán
橘皇=Quất Hoàng
渡鱼=Độ Ngư
陈时=Trần Thời
邱雅=Khâu Nhã
雾都=Vụ Đô
双花=Song Hoa
血龙=Huyết Long
秋白=Thu Bạch
周文=Chu Văn
苦禅=Khổ Thiện
李致=Lý Trí
郑夷=Trịnh Di
雷拳=Lôi Quyền
天佐=Thiên Tá
天帝=Thiên Đế
江浩=Giang Hạo
绵图=Miên Đồ
苏眉=Tô Mi
如曦=Như Hi
蛇王=Xà Vương
古典=Cổ Điển
首测=Thủ Trắc
集团=Tập Đoàn
空天=Không Thiên
胜堂=Thắng Đường
冯六=Phùng Lục
赵琼=Triệu Quỳnh
骨师=Cốt Sư
寸解=Thốn Giải
秋雨=Thu Vũ
骨室=Cốt Thất
花颜=Hoa Nhan
罗阳=La Dương
橘猫=Mèo quýt
幽女=U Nữ
春刀=Xuân Đao
王顺=Vương Thuận
雷狮=Lôi Sư
雾歌=Vụ Ca
雾界=Vụ Giới
不周=Bất Chu
命符=Mệnh Phù
凌绝=Lăng Tuyệt
卡灵=Thẻ Linh
乱流=Loạn Lưu
田十=Điền Thập
石焱=Thạch Diễm
邪异=Tà Dị
江阳=Giang Dương
气感=Khí Cảm
盗主=Đạo Chủ
明凉=Minh Lương
门弟=môn đệ
帮名=Bang Danh
幺哥=Yêu Ca
洪恺=Hồng Khải
霜蛊=Sương Cổ
一铭=Nhất Minh
卵五=Noãn Ngũ
御卷=Ngự Quyển
穆尔=Moore
弓术=Cung Thuật
乱行=Loạn Hành
羽刃=Vũ Nhận
毒生=Độc Sinh
蓝熊=Lam Hùng
赫猊=Hách Nghê
苍火=Thương Hỏa
罪罚=Tội Phạt
宫祭=Cung Tế
红鬼=Quỷ Đỏ
神符=Thần Phù
张符=tấm phù
捧沙=nắm cát
飞月=Phi Nguyệt
圣选=Thánh Tuyển
空劫=Không Kiếp
都锝=Đô Đắc
命障=Mệnh Chướng
巨身=Cự Thân
家臣=Gia Thần
瞳剑=Đồng Kiếm
生界=Sinh Giới
苏情=Tô Tình
摇光=Diêu Quang
道痴=Đạo Si
万影=Vạn Ảnh
深影=Thâm Ảnh
裂杀=Liệt Sát
鬼雄=Quỷ Hùng
界族=Giới Tộc
死界=Tử Giới
喵姐=Miêu tỷ
柒若=Thất Nhược
赤鹄=Xích Hộc
凡界=Phàm Giới
塌方=sạt lở
层岩=Tầng Nham
弓菱=Cung Lăng
封品=Phong Phẩm
七省=bảy tỉnh
胸章=Hung Chương
天蝎=Thiên Hạt
龙拳=Long Quyền
裂血=Liệt Huyết
仙船=Tiên Thuyền
浮都=Phù Đô
帝师=Đế Sư
恶面=Ác Diện
鬼庙=Quỷ Miếu
沈锋=Trầm Phong
小锋=Tiểu Phong
鑫城=Hâm Thành
死河=Tử Hà
小薇=Tiểu Vi
血舐=Huyết Thỉ
生河=Sinh Hà
黑索=Hắc Tác
月歌=Nguyệt Ca
家犬=Gia Khuyển
黑背=Béc Giê
赴火=Phó Hỏa
辉城=Huy Thành
悲仰=Bi Ngưỡng
摇人=Diêu Nhân
苏喂=Tô Uy
魔泉=Ma Tuyền
小魔=Tiểu Ma
血海=Huyết Hải
唐凌=Đường Lăng
张放=Trương Phóng
鬼噬=Quỷ Phệ
仙山=Tiên Sơn
仙塔=Tiên Tháp
仙念=Tiên niệm
本龙=bản Long
楚峰=Sở Phong
九轩=Cửu Hiên
山鬼=Sơn Quỷ
乱穿=xuyên bậy
百花=Bách Hoa
龙祖=Long Tổ
界力=Giới Lực
圣冠=Thánh Quan
的匙=chìa khóa
铁男=Thiết Nam
柳夜=Liễu Dạ
彩葬=Thải Táng
煞笔=sỏa bức
蛋语=ngôn ngữ trứng
圣哨=Thánh Tiếu
圣所=Thánh Sở
黑城=Hắc Thành
六道=Lục Đạo
均富=quân phú
周昊=Chu Hạo
林烨=Lâm Diệp
饕餮=Thao Thiết
村守=Thôn Thủ
顾村=Cố thôn
巡守=Tuần Thủ
林庸=Lâm Dung
大越=Đại Việt
武卒=Võ Tốt
程头=Trình đầu
贴符=dán phù
九坪=Cửu Bình
雷鬼=Lôi Quỷ
司神=Tư Thần
高羡=Cao Tiễn
肥宅=mập trạch
凡弓=Phàm Cung
姜皓=Khương Hạo
风狱=Phong Ngục
光狱=Quang Ngục
青楼=thanh lâu
重叙=xếp lại thứ tự
邪鬼=Tà Quỷ
劫主=Kiếp Chủ
林晚=Lâm Vãn
傅越=Phó Việt
涮肉=thịt chần
墓河=Mộ Hà
白僧=Bạch Tăng
老谁=Lão Thùy
小谁=Tiểu Thùy
圣洗=Thánh Tẩy
熵解=Thương Giải
圣轮=Thánh Luân
烈者=Liệt Giả
火环=Hỏa Hoàn
燕返=Yến Phản
招财=Chiêu Tài
定界=Định Giới
乐语=Nhạc Ngữ
小琅=Tiểu Lang
无因=Vô Nhân
偏神=Thiên Thần
顾佐=Cố Tá
塔庙=Tháp Miếu
相声=tấu nói
吴恢=Ngô Khôi
千尘=Thiên Trần
七王=Thất Vương
万护=Vạn Hộ
长殿=Trường Điện
秘匙=chìa khóa bí mật
语冰=nói rét
神姬=Thần Cơ
咒子=Chú Tử
虫魔=Trùng Ma
死焰=Tử Diễm
地神=Địa Thần
夜雪=Dạ Tuyết
深雪=Thâm Tuyết
永灭=Vĩnh Diệt
守序=Thủ Tự
剑风=Kiếm Phong
死斗=Tử Đấu
兽之=Thú Chi
圣律=Thánh Luật
周言=Chu Ngôn
黎九=Lê Cửu
海命=Hải Mệnh
虫甲=Trùng Giáp
食圣=Thực Thánh
骨林=Cốt Lâm
刀童=Đao Đồng
兵童=Binh Đồng
龙涛=Long Đào
劫乱=Kiếp Loạn
虫雕=Trùng Điêu
张九=Trương Cửu
龟圣=Quy Thánh
血月=Huyết Nguyệt
众灵=Chúng Linh
景真=Cảnh Chân
液神=Dịch Thần
神基=Thần Cơ
恨鬼=Hận Quỷ
之咒=Chú
龙币=Long Tệ
三术=Tam Thuật
君长=quân trưởng
绯影=Phi Ảnh
星时=Tinh Thời
雷怒=Lôi Nộ
电涌=Điện Dũng
鸡爷=Kê gia
圣国=Thánh Quốc
雷冲=Lôi Xung
虫刃=Trùng Nhận
魔皇=Ma Hoàng
小叙=Tiểu Tự
寒寺=Hàn Tự
杀门=Sát Môn
余白=Dư Bạch
天阙=Thiên Khuyết
圣舞=Thánh Vũ
肉肉=Nhục Nhục
曾侠=Tăng Hiệp
楚园=Sở Viên
单截=Đơn Đoạn
仇哥=Cừu ca
南月=Nam Nguyệt
章焕=Chương Hoán
归流=Quy Lưu
邪魔=Tà Ma
九面=Cửu Diện
林禁=Lâm Cấm
夏生=Hạ Sinh
卫霓=Vệ Nghê
采风=Thải Phong
刺咒=Thứ Chú
汲魂=Cấp Hồn
风斩=Phong Trảm
风闻=Phong Văn
古魔=Cổ Ma
孤行=Cô Hành
永护=Vĩnh Hộ
破魔=Phá Ma
邪文=Tà Văn
李炎=Lý Viêm
韩妍=Hàn Nghiên
流鳞=Lưu Lân
凶虎=Hung Hổ
魔鸟=Ma Điểu
鹅兄=Ngỗng huynh
露露=Lộ Lộ
叶威=Diệp Uy
抽牌=rút bài
宁月=Ninh Nguyệt
绵羊=Miên Dương
墟墓=Khư Mộ
玉城=Ngọc Thành
玉荆=Ngọc Kinh
羽数=Vũ Số
守御=Thủ Ngự
熵灭=Thương Diệt
所系=sở hệ
君绝=Quân Tuyệt
原虚=Nguyên Hư
圣骸=Thánh Hài
骨妖=Cốt Yêu
光灵=Quang Linh
解骨=Giải Cốt
鹿鸣=Lộc Minh
顾爸=Cố Ba
柳平=Liễu Bình
卦圣=Quẻ Thánh
洪涛=Hồng Đào
黎郎=Lê Lang
天坠=Thiên Trụy
狼妖=Lang Yêu
齐律=Tề Luật
小妖=Tiểu Yêu
副卡=thẻ phụ
西荒=Tây Hoang
扶云=Phù Vân
太微=Thái Vi
术刀=Thuật Đao
断杵=chày gãy
怜雨=Liên Vũ
秘调=Bí Điều
厌鬼=Yếm Quỷ
雪影=Tuyết Ảnh
怜雪=Liên Tuyết
离愁=Ly Sầu
长雪=Trường Tuyết
王薇=Vương Vi
狱灵=Ngục Linh
全押=toàn bộ thế chấp
大丑=Đại Sửu
蝎女=nữ bọ cạp
套卡=bộ bài
方片=Quân Rô
梅花=Quân Chuồn
神柱=Thần Trụ
剑仙=Kiếm Tiên
寻隐=Tầm Ẩn
破壁=Phá Bích
鬼骸=Quỷ Hài
融魂=Dung Hồn
天女=Thiên Nữ
婵衣=Thiền Y
亚娜=Iana
烈犬=Liệt Khuyển
火牙=Hỏa Nha
胜武=Thắng Võ
飞魔=Phi Ma
凛冬=Lẫm Đông
信魔=Tín Ma
绿龙=Lục Long
妖犬=Yêu Khuyển
波旁=Bourbon
杜雷=Đỗ Lôi
萧执=Tiêu Chấp
愿墙=Nguyện Tường
南校=Nam Hiệu
丽丽=Lệ Lệ
3D=3D
小鸦=Tiểu Quạ
小乌=Tiểu Ô
夏鲵=Hạ Nghê
鬼焰=Quỷ Diễm
猜魔=Sai Ma
小施=Tiểu Thi
李岁=Lý Tuế
陆乙=Lục Ất
君羽=Quân Vũ
虎鹤=Hổ Hạc
芷冰=Chỉ Băng
吹梦=Thổi Mộng
小红=Tiểu Hồng
炎杀=Viêm Sát
火蝶=Hỏa Điệp
黎兵=Lê Binh
刘润=Lưu Nhuận
丁涛=Đinh Đào
De=De
罪狱=Tội Ngục
江夏=Giang Hạ
伥鬼=Trành Quỷ
千手=Thiên Thủ
水猴=Thủy Hầu
金猴=Kim Hầu
草堂=Thảo Đường
蓝星=Lam Tinh
沈夜=Thẩm Dạ
夜哥=Dạ ca
沈爸=Thẩm ba
沈妈=Thẩm mẹ
温娜=Ôn Na
清允=Thanh Doãn
音尘=Âm Trần
佩奇=Peppa
云野=Vân Dã
阿义=A Nghĩa
息壤=Tức Nhưỡng
南海=Nam Hải
雷掌=Lôi Chưởng
霜咬=Sương Giảo
流月=Lưu Nguyệt
霜风=Sương Phong
孙彪=Tôn Bưu
嘴法=Chủy Pháp
法眼=Pháp Nhãn
法界=Pháp Giới
太白=Thái Bạch
襄王=Tương Vương
听雪=Thính Tuyết
夕=Tịch
琳=Lâm
霜=Sương
琴=Cầm
饪=nấu nướng
俪=Lệ
弓=cung
燚=Diệc
宋生宝=Tống Sinh Bảo
林党=Lâm đảng
闵宁=Mẫn Ninh
闵鸣=Mẫn Minh
青媒姥姥=Thanh Môi Mỗ Mỗ
鹰落功=Ưng Lạc Công
柔骨剑=Nhu Cốt Kiếm
闵姑娘=Mẫn cô nương
林阁老=Lâm các lão
薛攸葛=Tiết Du Cát
曾役长=Tằng dịch trường
三天人=Tam Thiên Nhân
周依棠=Chu Y Đường
寅剑山=Dần Kiếm Sơn
李生令=Lý Sinh Lệnh
周剑甲=Chu kiếm giáp
三尸九虫=Tam Thi Cửu Trùng
鹰落=Ưng Lạc
陈百户=Trần bách hộ
吴庆胜=Ngô Khánh Thắng
李百户=Lý bách hộ
李济生=Lý Tế Sinh
闵千户=Mẫn thiên hộ
白狮=Bạch Sư
夜魇大君=Dạ Yểm Đại Quân
血夜凋零曲=Huyết Dạ Điêu Linh Khúc
梦鹫大君=Mộng Thứu Đại Quân
谋帅的大君=Mưu Soái Đại Quân
星厌大君=Tinh Yếm Đại Quân
谋帅=Mưu Soái
大日行天功=Đại Nhật Hành Thiên Công
东明=Đông Minh
MCN=MCN
第一河=Đệ Nhất Hà
蜀辞=Thục Từ
云书朗=Vân Thư Lãng
子嫣=Tử Yên
云, 陶两家=Vân, Đào hai nhà
浣衣娘=Hoán Y Nương
荷砂=Hà Sa
小南=tiểu Nam
吕坤=Lữ Khôn
仙雷体=Tiên Lôi Thể
南宫神=Nam Cung Thần
木神分身=Mộc Thần Phân Thân
赶尸派=Cản Thi phái
胜男=Thắng Nam
苍渊圣主=Thương Uyên thánh chủ
青菱=Thanh Lăng
苍渊宗=Thương Uyên tông
神榜=Thần Bảng
闵氏姐妹=Mẫn thị tỷ muội
绣春刀=Tú Xuân Đao
勿用楼=Vật Dụng Lâu
刘时=Lưu Thời
马磴=Mã Đặng
马登=Mã Đăng
浣衣局=Hoán Y Cục
董婉昕=Đổng Uyển Hân
兰皋坊=Lan Cao Phường
玉儿=Ngọc Nhi
方小姑娘=Phương tiểu cô nương
龙侯=Long Hầu
东国学都=Đông Quốc Học Đô
烈土国=Liệt Thổ Quốc
炎王轰=Viêm Vương Oanh
苍风界=Thương Phong Giới
苍风上界=Thương Phong Thượng Giới
苍风血脉=Thương Phong Huyết Mạch
木木行云=Mộc Mộc Hành Vân
雷世清=Lôi Thế Thanh
沈泽=Thẩm Trạch
摄魂眼=Nhiếp Hồn Nhãn
魂剑=Hồn Kiếm
封天=Phong Thiên
乾幻柔=Càn Huyễn Nhu
封灵境=Phong Linh Cảnh
全德=Toàn Đức
昭南苑=Chiêu Nam Uyển
高海=Cao Hải
宋宗子的文集=Tống Tông Tử Đích Văn Tập
宋宗子文集=Tống Tông Tử Văn Tập
慈安宫=Từ An Cung
chiêu Nam Uyển=Chiêu Nam Uyển
齐嫔=Tề tần
璇华宫=Toàn Hoa Cung
王喜=Vương Hỉ
陈郡=Trần Quận
端嫔=Đoan Tần
安婕妤=An Tiệp Dư
姝婕妤=Thù Tiệp Dư
夏灵=Hạ Linh
佛经=Phật Kinh
萧圳=Tiêu Quyến
闵家=Mẫn gia
闵贺=Mẫn Hạ
李掌刑=Lý Chưởng Hình
陈尊明=Trần Tôn Minh
天妖令=Thiên Yêu Lệnh
灵渊古城=Linh Uyên Cổ Thành
鸪南翔=Cô Nam Tường
秦贤=Tần Hiền
苍风老祖=Thương Phong Lão Tổ
金阳城=Kim Dương Thành
少阴=Thiếu Âm
牵星术=Khiên Tinh Thuật
青帝遗木=Thanh Đế Di Mộc
长生祠=Trường Sinh Từ
伊天行=Y Thiên Hành
厂址=Xưởng Chỉ
紫宫=Tử Cung
宋同=Tống Đồng
萧昭仪=Tiêu Chiêu Nghi
苍渊石坊=Thương Uyên Thạch Phường
毛怪之墓=Mao Quái Chi Mộ
凤鸾=Phượng Loan
方! 歌! 渔=Phương! Ca! Ngư
夜国的朝堂=Dạ Quốc triều đình
散星驿=Tản Tinh Dịch
冯轩=Phùng Hiên
梁平=Lương Bình
人皇心经=Nhân Hoàng Tâm Kinh
穴道篇=Huyệt Đạo Thiên
三角牛族=Tam Giác Ngưu Tộc
苏惊蛰=Tô Kinh Chập
张秀=Trương Tú
宁开山=Ninh Khai Sơn
燕霞=Yến Hà
春栖酒楼=Xuân Tê tửu lâu
春栖楼=Xuân Tê Lâu
桃花巷=hẻm Đào Hoa
霜降=Sương Giáng
惊蛰=Kinh Chập
翠柳巷=hẻm Thúy Liễu
翠柳学堂=Thúy Liễu Học Đường
陈道友=Trần đạo hữu
陈金石=Trần Kim Thạch
林晏=Lâm Yến
林籍=Lâm Tịch
于家父=Vu gia phụ
太始拳=Thái Thủy Quyền
凰祖=Hoàng Tổ
天水圣地=Thiên Thủy thánh địa
沈开山=Thẩm Khai Sơn
百里... 仙仙=Bách Lý... Tiên Tiên
百里仙仙=Bách Lý Tiên Tiên
月玄境=Nguyệt Huyền Cảnh
千娇女国=Thiên Kiều Nữ Quốc
千娇学府=Thiên Kiều Học Phủ
兽契盟=Thú Khế Minh
兵契盟=Binh Khế Minh
玉山学院=Ngọc Sơn Học Viện
武卫=Võ Vệ
武威学院=Võ Uy Học Viện
眠龙=Miên Long
雨瀑=Vũ Bộc
第一皇家学院=Đệ Nhất Hoàng Gia Học Viện
朝阳=Triều Dương
烈土=Liệt Thổ
第一联合学院=Đệ Nhất Liên Hợp Học Viện
明光阵=Minh Quang Trận
程宣=Trình Tuyên
程雨晨=Trình Vũ Thần
寻龙诀=Tầm Long Quyết
寻道人=Tầm Đạo Nhân
长生蜉蝣木=Trường Sinh Phù Du Mộc
赵无眠=Triệu Vô Miên
李炬阳=Lý Cự Dương
告国=Cáo Quốc
天英城=thành Thiên Anh
卧虎村=thôn Ngọa Hổ
卧虎村的人=người thôn Ngọa Hổ
龙云凤=Long Vân Phượng
炬阳儿=Cự Dương nhi
下三品=Hạ Tam Phẩm
中三品=Trung Tam Phẩm
上三品=Thượng Tam Phẩm
先天=Tiên Thiên
炬阳=Cự Dương
幽燕之地=U Yến Chi Địa
钟黎=Chung Lê
宁瑶=Ninh Dao
苍山拳=Thương Sơn Quyền
玉阶=Ngọc Giai
妗柔=Cấm Nhu
冯元=Phùng Nguyên
钟鼓司=Chung Cổ Ti
混堂司=Hỗn Đường Ti
都前司=Đô Tiền Ti
祝睿妤=Chúc Duệ Dư
傀魔真身=Khôi Ma Chân Thân
傀魔经=Khôi Ma Kinh
炼傀经=Luyện Khôi Kinh
龙象镇狱经=Long Tượng Trấn Ngục Kinh
方小渔=Phương Tiểu Ngư
百里侯=Bách Lý hầu
太阳神石=Thái Dương Thần Thạch
白云将军=Bạch Vân tướng quân
雨晨=Vũ Thần
神兵国=Thần Binh Quốc
仓啷=Thương Lang
叶万仓=Diệp Vạn Thương
苏青绮=Tô Thanh Khởi
墨邪=Mặc Tà
幽铃=U Linh
太衍圣教=Thái Diễn Thánh Giáo
炼体=Luyện Thể
炼神=Luyện Thần
蟒鳞劲=Mãng Lân Kình
神游=Thần Du
殷齐=Ân Tề
安后=An Hậu
定安党=Định An Đảng
王固=Vương Cố
郑严卓=Trịnh Nghiêm Trác
唐艺梦=Đường Nghệ Mộng
古客卿=Cổ khách khanh
楚音=Sở Âm
开元小境=Khai Nguyên tiểu cảnh
探灵·封空=Thám Linh·Phong Không
玄上=Huyền Thượng
顾白=Cố Bạch
彗星=Tuệ Tinh
玄隐游仙=Huyền Ẩn Du Tiên
庆一璇=Khánh Nhất Toàn
清衍升仙诀=Thanh Diễn Thăng Tiên Quyết
合欢铃=Hợp Hoan Linh
太衍寒冰=Thái Diễn Hàn Băng
三欲神系统=Tam Dục Thần Hệ Thống
冥泉=Minh Tuyền
太衍仙玉=Thái Diễn Tiên Ngọc
琪云=Kỳ Vân
柳琪云=Liễu Kỳ Vân
灵丹=Linh Đan
太御符=Thái Ngự Phù
潜痕=Tiềm Ngấn
四大门派的起源=Tứ Đại Môn Phái Khởi Nguyên
冰天山=Băng Thiên Sơn
抹邪丹=Mạt Tà Đan
气元丹=Khí Nguyên Đan
林佑=Lâm Hữu
楚琼华=Sở Quỳnh Hoa
鸣长钟=Minh Trường Chung
火云谷=Hỏa Vân Cốc
天佑玉无双=Thiên Hữu Ngọc Vô Song
焚幽女帝=Phần U Nữ Đế
白远山=Bạch Viễn Sơn
唐宝玉=Đường Bảo Ngọc
宝玉=Bảo Ngọc
姜红衣=Khương Hồng Y
问心剑=Vấn Tâm Kiếm
小佑=Tiểu Hữu
凡三境=Phàm Tam Cảnh
灵三境=Linh Tam Cảnh
仙三境=Tiên Tam Cảnh
焚幽门=Phần U Môn
云锦县=huyện Vân Cẩm
邪月宗=Tà Nguyệt Tông
呼救符=Hô Cứu Phù
无名老嬷=Vô Danh lão ma
三阳散气=Tam Dương Tản Khí
曦月=Hi Nguyệt
天水宗=Thiên Thủy Tông
穆凝=Mục Ngưng
巫罗妖虫=Vu La Yêu Trùng
第六河=Đệ Lục Hà
血羽河=Huyết Vũ Hà
叮叮=Đinh Đinh
地火铁精=Địa Hỏa Thiết Tinh
玄龟炼宝诀=Huyền Quy Luyện Bảo Quyết
林土=Lâm Thổ
杭州师大=Đại học Sư Phạm Hàng Châu
宋恩妍=Tống Ân Nghiên
许可=Hứa Khả
何京=Hà Kinh
曹铭志=Tào Minh Chí
赵胤辰=Triệu Dận Thần
许思柳=Hứa Tư Liễu
周诗雨=Chu Thi Vũ
白教官=huấn luyện viên Bạch
邓雪峰=Đặng Tuyết Phong
熊, 熊二=Hùng, Hùng Nhị
反向的种=Quay Ngược Lại(Phản Hướng Đích Chủng)
夜的第七章=Dạ Đích Đệ Thất Chương
一路向北=Nhất Lộ Hướng Bắc
告白气球=Tỏ Tình Khí Cầu
赵嘉羽=Triệu Gia Vũ
浙省=Chiết Tỉnh
司法界=Giới Tư Pháp
姜敏=Khương Mẫn
许世杰=Hứa Thế Kiệt
许诺=Hứa Nặc
姜允诺=Khương Doãn Nặc
良城=Lương Thành
黄湘云=Hoàng Tương Vân
恩妍=Ân Nghiên
飘移女王=Phiêu Di Nữ Vương
水城=Thủy Thành
小熊=Tiểu Hùng
冥皇诀=Minh Hoàng Quyết
星灵法=Tinh Linh Pháp
焚幽主峰=Phần U Chủ Phong
记忆书鉴=Ký Ức Thư Giám
荡邪=Đãng Tà
池二=Trì Nhị
醉春楼=Túy Xuân Lâu
李都公=Lý đô công
孙耿=Tôn Cảnh
沐仙子=Mộc tiên tử
雨洛=Vũ Lạc
琼依=Quỳnh Y
沐琼依=Mộc Quỳnh Y
小君君=Tiểu Quân Quân
百里姑娘=Bách Lý cô nương
呼噜=Hô Lỗ
康婵武=Khang Thiền Võ
虎十=Hổ Thập
盘丹鼎=Bàn Đan Đỉnh
熊文浩=Hùng Văn Hạo
张思琪=Trương Tư Kỳ
空月山=Không Nguyệt Sơn
寰州=Hoàn Châu
云霞山=Vân Hà Sơn
殷惟郢=Ân Duy Dĩnh
池方桓=Trì Phương Hoàn
蔡衡杰=Thái Hành Kiệt
戏世醉灯=Hí Thế Túy Đăng
狗叔=Cẩu Thúc
清澜城=thành Thanh Lan
李慕=Lý Mộ
李御白=Lý Ngự Bạch
柳若樱=Liễu Nhược Anh
化婴=Hóa Anh
无量=Vô Lượng
渡劫=Độ Kiếp
飞升=Phi Thăng
林青竹=Lâm Thanh Trúc
林喻=Lâm Dụ
青竹=Thanh Trúc
清澜学院=Thanh Lan Học Viện
韩夜=Hàn Dạ
司徒云=Tư Đồ Vân
司徒云梦=Tư Đồ Vân Mộng
天箭=Thiên Tiễn
巨剑林=Cự Kiếm Lâm
怒焱=Nộ Diễm
重楼=Trọng Lâu
鸣剑堂=Minh Kiếm Đường
司徒胜=Tư Đồ Thắng
大力门=Đại Lực Môn
纪文龙=Kỷ Văn Long
陈耀海=Trần Diệu Hải
玉泉道长=Ngọc Tuyền đạo trường
陈雪燕=Trần Tuyết Yến
吴涵=Ngô Hàm
军皇阁=Quân Hoàng Các
孔武=Khổng Võ
茗香斋=Minh Hương Trai
章道友=Chương đạo hữu
王师伯=Vương Sư Bá
章师伯=Chương sư bá
章洪=Chương Hồng
广陵散=Quảng Lăng Tản
闵月池=Mẫn Nguyệt Trì
嵇康=Kê Khang
朝菌=Triều Khuẩn
蟪蛄=Huệ Cô
晦朔=Hối Sóc
唐锡=Đường Tích
唐歆=Đường Hâm
温媱=Ôn Dao
汤昆=Thang Côn
汤贵=Thang Quý
唐明轩=Đường Minh Hiên
卷珠帘=Quyển Châu Liêm
刘庆=Lưu Khánh
艾侄女=Ngải điệt nữ
宋行长=Tống chủ tịch
孙台长=Tôn đài trưởng
先天潮汐圣体=Tiên Thiên Triều Tịch Thánh Thể
红芍=Hồng Thược
红樱=Hồng Anh
愈魂丹=Dũ Hồn Đan
金刚丹=Kim Cương Đan
时宫=Thời Cung
魔尸叉=Ma Thi Xoa
血妖宗=Huyết Yêu Tông
潮汐圣体=Triều Tịch Thánh Thể
落仙裙=Lạc Tiên Quần
屠胜男=Đồ Thắng Nam
鬼泣珠=Quỷ Khấp Châu
方卓=Phương Trác
方卓杭=Phương Trác Hàng
方卓仲=Phương Trác Trọng
李从心=Lý Tòng Tâm
炎爆=Viêm Bạo
杨勋=Dương Huân
张家=Trương gia
越国=Việt quốc
张重=Trương Trọng
止元城=Chỉ Nguyên Thành
紫耀龙=Tử Diệu Long
于成永=Vu Thành Vĩnh
于书记=Vu thư ký
白茯苓=Bạch Phục Linh
唐正浩=Đường Chính Hạo
郞淮=Lang Hoài
苏雪竹=Tô Tuyết Trúc
耀光步=Diệu Quang Bộ
幻形剑法=Huyễn Hình Kiếm Pháp
大日行天法=Đại Nhật Hành Thiên Pháp
傅义国=Phó Nghĩa Quốc
秦琬夕=Tần Uyển Tịch
决明阳春树=Quyết Minh Dương Xuân Thụ
Minh Hoàng biến=Minh Hoàng Biến
三花断流=Tam Hoa Đoạn Lưu
烟姬=Yên Cơ
太子山=Thái Tử Sơn
马施=Mã Thi
风晴雅=Phong Tình Nhã
蛟龙血=Giao Long Huyết
黄六清=Hoàng Lục Thanh
萧统领=Tiêu thống lĩnh
helloKitty=Hello Kitty
叶璃儿=Diệp Ly Nhi
紫霜=Tử Sương
若雪=Nhược Tuyết
方龙=Phương Long
卜道友=Bốc đạo hữu
江小雪=Giang Tiểu Tuyết
法相天地=Pháp Tương Thiên Địa
瀚海宝典=Hãn Hải Bảo Điển
徐洋=Từ Dương
赤蛇鞭=Xích Xà Tiên
牛逼丹=Ngưu Bức Đan
唐瑜婕=Đường Du Tiệp
风斩雨=Phong Trảm Vũ
千灯庙=Thiên Đăng Miếu
北海帮=Bắc Hải Bang
罗刹李=La Sát Lý
飞元真人=Phi Nguyên Chân Nhân
管可儿=Quản Khả Nhi
周洪=Chu Hồng
罗明涛=La Minh Đào
方爽=Phương Sảng
肉佛门=Nhục Phật Môn
巨鳞山=Cự Lân Sơn
< 画皮 >=< Họa Bì >
< 画心 >=< Họa Tâm >
张靓颖=Trương Tịnh Dĩnh
琼华=Quỳnh Hoa
摧风=Tồi Phong
左怀武=Tả Hoài Võ
廖稷=Liêu Tắc
姜曦月=Khương Hi Nguyệt
巨刃红族=Cự Nhận Hồng Tộc
巨刃红老九=Cự Nhận Hồng Lão Cửu
马宁=Mã Ninh
茶青青=Trà Thanh Thanh
钱江新城=Tiền Giang Tân Thành
若曦姐=Nhược Hi tỷ
若曦=Nhược Hi
百夜洛书=Bách Dạ Lạc Thư
东野五马=Đông Dã Ngũ Mã
邪医谷=Tà Y Cốc
荷藤=Hà Đằng
丽鸢=Lệ Diên
聚宝阁=Tụ Bảo Các
姜维=Khương Duy
都公=Đô công
郭坛=Quách Đàn
艾母=Ngải mẫu
明珠城=thành Minh Châu
马长老=Mã trường lão
赫尔伽诺恩=Helganorn
库迦=Kuga
贞娜=Trinh Na
赖玲=Lại Linh
梅根娜=Meghan
芙蕾德=Frederica
紫眼睛的占卜家=Người Xem Bói mắt tím
好奇的魔女=Ma Nữ Tò Mò
嘉琳娜·卡文迪许=Carina Cavendish 
无廉耻的丑=Kẻ xấu xí không liêm xỉ
宫廷大丑=Cung Đình Đại Sửu
万象有常牌=Vạn Tượng Hữu Thường Bài
王充礼=Vương Sung Lễ
充礼=Sung Lễ
王枞=Vương Tung
马梁平=Mã Lương Bình
落月白=Lạc Nguyệt Bạch
闵役长=Mẫn dịch trường
野哥=Dã ca
无生河=Vô Sinh Hà
李二猫=Lý Nhị Miêu
深渊溺亡者教团=Thâm Uyên Nịch Vong Giả Giáo Đoàn
楚飞云=Sở Phi Vân
刘意=Lưu Ý
落道友=Lạc đạo hữu
晴雅=Tình Nhã
冯鹰=Phùng Ưng
冯罗=Phùng La
芳玉轩=Phương Ngọc Hiên
柳霄辰=Liễu Tiêu Thần
裴元=Bùi Nguyên
双角游龙=Song Giác Du Long
撕天=Tê Thiên
圣骑士=Thánh Kỵ Sĩ
陈国松=Trần Quốc Tùng
钟苒=Chung Nhiễm
门神庙=Môn Thần Miếu
窦玉=Đậu Ngọc
张横茂=Trương Hoành Mậu
郭俊奇=Quách Tuấn Kỳ
太一元气经=Thái Nhất Nguyên Khí Kinh
嬴公子=Doanh công tử
景月宗=Cảnh Nguyệt tông
柳裴元=Liễu Bùi Nguyên
Liễu Vân hiên=Liễu Vân Hiên
柳云轩=Liễu Vân Hiên
白芷=Bạch Chỉ
白伍=Bạch Ngũ
幽魂海=U Hồn Hải
血玉令=Huyết Ngọc Lệnh
池阴珠=Trì Âm Châu
月樱山=Nguyệt Anh Sơn
田墨兰=Điền Mặc Lan
军山印=Quân Sơn Ấn
九金狮=Cửu Kim Sư
闵少侠=Mẫn thiếu hiệp
白柳派=Bạch Liễu phái
游胥=Du Tư
白柳刀=Bạch Liễu Đao
艾小姐=Ngải tiểu thư
涅魔经=Niết Ma Kinh
缪晨=Mâu Thần
张曜堂=Trương Diệu Đường
张曜宗=Trương Diệu Tông
燕芸=Yến Vân
七大族文字初解=Thất Đại Tộc Văn Tự Sơ Giải
百族古文字注解=Bách Tộc Cổ Văn Tự Chú Giải
金墙=Kim Tường
鱼骨海盗船=Thuyền Hải Tặc Xương Cá
清心决=Thanh Tâm Quyết
道心如鹤=Đạo Tâm Như Hạc
阿杰莉娜=Angelina
梁珊都=Lương San Đô
梁珊=Lương San
幽璇玑=U Toàn Cơ
李灵玉=Lý Linh Ngọc
风小姐=Phong tiểu thư
通玄真人=Thông Huyền Chân Nhân
琦姐=Kỳ Tỷ
喂羊=Uy Dương
教皇国=Giáo Hoàng Quốc
庞亚空间= Không Gian Bàng Á
阿芙罗拉=Aurora
海莉·阿芙罗拉=Hayley Aurora 
华天池=Hoa Thiên Trì
江兰兰=Giang Lan Lan
金石=Kim Thạch
刘冰岩=Lưu Băng Nham
黄阁老=Hoàng các lão
崔成锦=Thôi Thành Cẩm
邵女士=Thiệu nữ sĩ
芹姐=Cần tỷ
魏阳=Ngụy Dương
小忘川=Tiểu Vong Xuyên
镇鬼的符文=phù văn Trấn Quỷ
贾鸿=Giả Hồng
吴健=Ngô Kiện
吴白=Ngô Bạch
白雾娜=Bạch Vụ Na
白雾娜·卡文迪许=Bạch Vụ Na Cavendish 
月华之水=Nguyệt Hoa Chi Thủy
尊明=Tôn Minh
东宫艾=Đông Cung Ngải
蔡浩=Thái Hạo
罗宇=La Vũ
苏青天=Tô Thanh Thiên
顾怀=Cố Hoài
熊罡=Hùng Cương
青韵=Thanh Vận
潜息术=Tiềm Tức Thuật
铁血皇女=Thiết Huyết Hoàng Nữ
伊希丝=Yixi
路西欧=Lucio
白师伯=Bạch sư bá
燕赤雄=Yến Xích Hùng
郑齐游=Trịnh Tề Du
乔伯伯=Kiều bá bá
温涛=Ôn Đào
东子=Đông tử
伽诺恩=Ganuo'en
西尔维娅小姐=tiểu thư Sylvia
阿芙罗拉小姐=tiểu thư Aurora
段绍武=Đoạn Thiệu Võ
羽化殿=Vũ Hóa Điện
欧阳青=Âu Dương Thanh
夜露=Dạ Lộ
筑固道基=Trúc Cố Đạo Cơ
初开洞府=Sơ Khai Động Phủ
以炁御物=Dĩ Khí Ngự Vật
邱费=Khưu Phí
吕辉=Lữ Huy
皓月圣地=Hạo Nguyệt Thánh Địa
贝纳妮丝=Bernice
嘉羽=Gia Vũ
升仙塔=Thăng Tiên Tháp
太上玄元功=Thái Thượng Huyền Nguyên Công
惟郢=Duy Dĩnh
林琬悺=Lâm Uyển Quan
贞兰=Trinh Lan
玉真元君=Ngọc Chân Nguyên Quân
闵成府=Mẫn Thành Phủ
云襄=Vân Tương
次神器=Thứ Thần Khí
希维·阿芙罗拉=Hivey Aurora 
常其路=Thường Kỳ Lộ
第六0章=Chương 60:
妙玄=Diệu Huyền
唐正奇=Đường Chính Kỳ
宁晚棠=Ninh Vãn Đường
陆广文=Lục Quảng Văn
陆光文=Lục Quang Văn
徐玥=Từ Nguyệt
王娜=Vương Na
严卫东=Nghiêm Vệ Đông
孟鑫=Mạnh Hâm
孙羽=Tôn Vũ
明瑶=Minh Dao
通玄=Thông Huyền
罗祖=La Tổ
萱祖=Huyên Tổ
情姑=Tình Cô
司徒凌=Tư Đồ Lăng
恶魂钉=Ác Hồn Đinh
千秋岁=Thiên Thu Tuế
李无忌=Lý Vô Kị
阿奇姆=Achim
银泰广场=quảng trường Ngân Thái
东来=Đông Lai
天星法=Thiên Tinh Pháp
李念江=Lý Niệm Giang
李思兰=Lý Tư Lan
启灵仪式=nghi thức Khải Linh
薛城东=Tiết Thành Đông
淮县=Hoài huyện
宁不归=Ninh Bất Quy
花蓓=Hoa Bội
介黛=Giới Đại
姜梓墨=Khương Tử Mặc
山河魂=Sơn Hà Hồn
太阴经=Thái Âm Kinh
鼎炉篇=Đỉnh Lô Thiên
黎婉儿=Lê Uyển Nhi
何贵=Hà Quý
猿九灵=Viên Cửu Linh
鬼云儿=Quỷ Vân Nhi
孙震=Tôn Chấn
魏乾=Ngụy Càn
碎霄·千层浪=Toái Tiêu·Thiên Tầng Lãng
微风森林=Vi Phong Sâm Lâm
柯恩=Kha Ân
爱德华兹=Edwards
滨江=Tân Giang
胡晓慧=Hồ Hiểu Tuệ
杨玥=Dương Nguyệt
左主席=Tả chủ tịch
星辉战体=Tinh Huy Chiến Thể
封一=Phong Nhất
报公子=Báo công tử
春薄寺=chùa Xuân Bạc
涂山氏=Đồ Sơn Thị
海内经=Hải Nội Kinh
清文=Thanh Văn
小美=Tiểu Mỹ
篆符=Triện Phù
火狲=Hỏa Tôn
启灵塔=Khải Linh Tháp
小纸=Tiểu Chỉ
兮兮=Hề Hề
双王殿=Song Vương Điện
丁国民=Đinh Quốc Dân
左媛媛=Tả Viện Viện
纺绩=Phưởng Tích
太华神女=Thái Hoa Thần Nữ
尹俊南=Doãn Tuấn Nam
枫叶国=Phong Diệp Quốc
燕崇=Yến Sùng
李珊=Lý San
玥玥=Nguyệt Nguyệt
丁教授=Đinh giáo sư
灵芝姐姐=Linh Chi tỷ tỷ
宁非烟=Ninh Phi Yên
谢凯=Tạ Khải
张艳萍=Trương Diễm Bình
御灵门=Ngự Linh Môn
熙王世子=Hi Vương thế tử
道法宗=Đạo Pháp Tông
常慧君=Thường Tuệ Quân
山境之劫=Sơn Cảnh Chi Kiếp
第二河=Đệ Nhị Hà
王研玉=Vương Nghiên Ngọc
雷藏=Lôi Tàng
孙天岐=Tôn Thiên Kỳ
黑鲸岛=Hắc Kình đảo
酒痴=Tửu Si
巫祝=Vu Chúc
夏将=Hạ tướng
邱神医=Khưu thần y
张雷=Trương Lôi
伊丝蓓尔=Isabell
陆文涛=Lục Văn Đào
玥总=Nguyệt Tổng
崔武=Thôi Võ
封婵姐=Phong Thiền tỷ
魔雷经=Ma Lôi Kinh
刘娴=Lưu Nhàn
林润=Lâm Nhuận
谭宇冠=Đàm Vũ Quán
焚幽二长老=Phần U nhị trường lão
白莲佛母=Bạch Liên Phật Mẫu
殷仙姑=Ân tiên cô
鸾皇=Loan Hoàng
祝院士=Chúc viện sĩ
司徒凌风=Tư Đồ Lăng Phong
乾宇=Càn Vũ
暮夏王妃=Mộ Hạ vương phi
暮夏=Mộ Hạ
烁星城寨=Thước Tinh thành trại
江若蓉=Giang Nhược Dung
清原真经=Thanh Nguyên Chân Kinh
山海经东山经=Sơn Hải Kinh Đông Sơn Kinh
旧唐书=Cựu Đường Thư
乾苍=Càn Thương
宋允书=Tống Doãn Thư
杨惠婷=Dương Huệ Đình
张泽凯=Trương Trạch Khải
李泽楷=Lý Trạch Giai
毕平=Tất Bình
刘英=Lưu Anh
赵天阳=Triệu Thiên Dương
莲华呼魂术=Liên Hoa Hô Hồn Thuật
猿前辈=Viên tiền bối
宫小鱼=Cung Tiểu Ngư
小鱼=Tiểu Ngư
月迦=Nguyệt Già
王嫚依=Vương Mạn Y
顾警官=Cố cảnh quan
云朵儿=Vân Đóa Nhi
熊猫=Hùng Miêu
浙警学院=học viện Chiết Cảnh
熊妙妙=Hùng Diệu Diệu
李吗赵=Lý Mạ Triệu
杰克马=Jack Ma
白素姐=Bạch Tố Thư
冰天宫=Băng Thiên Cung
清衍圣=Thanh Diễn Thánh
清衍圣女=Thanh Diễn Thánh Nữ
玄鸾=Huyền Loan
玄光十二剑=Huyền Quang Thập Nhị Kiếm
季屿川=Quý Dữ Xuyên
朵兰=Dolores
斯洛妮=Umbridge
妙妙=Diệu Diệu
苏大师=Tô đại sư
青阳玄功=Thanh Dương Huyền Công
比丘尼=Tỉ Khưu Ni
周晚梦=Chu Vãn Mộng
第一0一章=Chương 101:
第一0二章=Chương 102:
白陆=Bạch Lục
日照经=Nhật Chiếu Kinh
太祖鳄=Thái Tổ Ngạc
暗精灵=Ám Tinh Linh
于主任=Vu chủ nhiệm
杀意真图=Sát Ý Chân Đồ
第一0四章=Chương 104:
山川神主=Sơn Xuyên Thần Chủ
睿妤=Duệ Dư
吴琼=Ngô Quỳnh
袁弘毅=Viên Hoằng Nghị
锡河=Tích Hà
刘沛松=Lưu Bái Tùng
赵胤臣=Triệu Dận Thần
第一0五章=Chương 105:
第一0六章=Chương 106:
安南王=An Nam Vương
墨虎=Mặc Hổ
李掌书记=Lý Chưởng thư ký
紫药丹鉴=Tử Dược Đan Giám
秀禾=Tú Hòa
关凌山=Quan Lăng Sơn
焚情印=Phần Tình Ấn
弹指剑=Đạn Chỉ Kiếm
红妆=Hồng Trang
女魔君=Nữ Ma Quân
立飞雨=Lập Phi Vũ
乾万山=Càn Vạn Sơn
苏游=Tô Du
虾子=Hà Tử
许龄月=Hứa Linh Nguyệt
李昀=Lý Vân
第一0七章=Chương 107:
第一0九章=Chương 109:
第一一0章=Chương 110:
曹金=Tào Kim
止戈司衙门=Chỉ Qua Tư Nha Môn
琬悺=Uyển Quan
镇剑使=Trấn Kiếm Sử
奥尔喀什=Auschwitz
棘花之火=Ngọn Lửa Gai/Ngọn Lửa Gai Góc
奥卡托=Aokato
格雷斯=Grace
埃鲁=Elu
埃鲁因=Aeruin
布契=Bucchi
布拉格斯=Bruggs
卡地雷哥=Kadirgo
布格斯=Burgess
沃恩德=Wonde
奉龙教团=Phụng Long Giáo Đoàn
六祖惠=Lục Tổ Huệ
六祖惠能=Lục Tổ Huệ Năng
百里府=Bách Lý Phủ
百里轩=Bách Lý Hiên
倪安娜=Nghê An Na
侯世宁=Hầu Thế Ninh
牧老=Mục lão
宋慧民=Tống Tuệ Dân
清净圣女=Thanh Tịnh Thánh Nữ
曾启明=Tằng Khải Minh
日游巡使=Nhật Du tuần sử
寅哉剑=Dần Tai Kiếm
莫冲=Mạc Xung
第一二0章=Chương 120:
曾百户=Tằng bách hộ
若疏=Nhược Sơ
活人剑=Hoạt Nhân Kiếm
杀人刀=Sát Nhân Đao
梅花之劫=Mai Hoa Chi Kiếp
谈先生=Đàm tiên sinh
江伯符=Giang Bá Phù
传灯道人=Truyền Đăng đạo nhân
仇罡=Cừu Cương
唐苦梅=Đường Khổ Mai
李谢灵=Lý Tạ Linh
纪菲=Kỷ Phỉ
巫阗=Vu Điền
圣奥尔索=Thánh Orso
李妙童=Lý Diệu Đồng
秦定虎=Tần Định Hổ
月首=Nguyệt Thủ
摧风斩雨=Tồi Phong Trảm Vũ
阿娆=A Nhiêu
黄霆君=Hoàng Đình Quân
林倾城=Lâm Khuynh Thành
沃恩泽=Warnze
李妙善=Lý Diệu Thiện
第一三0章=Chương 130:
断剑客=Đoạn Kiếm Khách
范宏=Phạm Hồng
吕殚=Lữ Đàn
孙杰=Tôn Kiệt
张展=Trương Triển
锦雅阁=Cẩm Nhã Các
薛清盛=Tiết Thanh Thịnh
福瑞斯=Forrest
铁无缺=Thiết Vô Khuyết
汪云菲=Uông Vân Phỉ
江若若=Giang Nhược Nhược
杨月露=Dương Nguyệt Lộ
第一四0章=Chương 140:
周时予=Chu Thời Dư
夏梦=Hạ Mộng
枫阿姨=Phong a di
百里名安=Bách Lý tên An
字藏剑=chữ Tàng Kiếm
玖玥=Cửu Nguyệt
封远=Phong Viễn
云丰=Vân Phong
裴北名=Bùi Bắc Danh
长孙千鹤=Trường Tôn Thiên Hạc
竹林别苑=Trúc Lâm Biệt Uyển
张旭渠=Trương Húc Cừ
名易=tên Dịch
通背神猿=Thông Bối Thần Viên
第一五0章=Chương 150:
林官爷=Lâm quan gia
赵央=Triệu Ương
安森=Ansen
安森六世=Ansen Đệ Lục
摩菈=Myra
蓉前辈=Dung tiền bối
秦蕊=Tần Nhụy
疯经师=Phong Kinh Sư
柳百里=Liễu Bách Lý
苍图=Thương Đồ
天华宝盖闭气功=Thiên Hoa Bảo Cái Bế Khí Công
九鸟=Cửu Điểu
白伯乐=Bạch Bá Nhạc
白柳=Bạch Liễu
席云淮=Tịch Vân Hoài
乔万里=Kiều Vạn Lý
金玉叶=Kim Ngọc Diệp
韩厉=Hàn Lệ
周任时=Chu Nhậm Thời
疗愈圣母教=Liệu Dũ thánh mẫu giáo
第一六0章=Chương 160:
唐巍=Đường Nguy
五佛山=Ngũ Phật Sơn
第一七0章=Chương 170:
澹台明镜=Đạm Đài Minh Kính
襄瑜=Tương Du
慈渡=Từ Độ
梵龙语=Phạn Long Ngữ
宋知昂=Tống Tri Ngang
韩承贤=Hàn Thừa Hiền
李慎之=Lý Thận Chi
沈海东=Thẩm Hải Đông
Đông hà núi=Đông Hà Núi
无色=Vô Sắc
斗虎=Đấu Hổ
白岩=Bạch Nham
霍海舟=Hoắc Hải Chu
昌庄=Xương Trang
韩谦=Hàn Khiêm
温暖=Ôn Noãn
畅享=Sướng Hưởng
林纵横=Lâm Tung Hoành
纵横哥哥=Tung Hoành ca ca
小暖=Tiểu Noãn
李金鹤=Lý Kim Hạc
小谦=Tiểu Khiêm
罗密欧四叶草=Alfa Romeo Cloverleaf
张昊唯=Trương Hạo Duy
马可欣=Mã Khả Hân
谦哥=Khiêm ca
荣耀集团的=tập đoàn Vinh Quang
荣耀集团=tập đoàn Vinh Quang
燕青青=Yến Thanh Thanh
虽然小暖=mắc dù Tiểu Noãn
明亮=Minh Lượng
宋菁=Tống Tinh
苏亮=Tô Lượng
策划部=Sách Hoa Bộ
康高=Khang Cao
小杨=Tiểu Dương
杨岚=Dương Lam
高副总=Cao phó tổng
北北=Bắc Bắc
杨佳=Dương Giai
风华装饰=Phong Hoa Trang Sức
孙雅=Tôn Nhã
高履行=Cao Lữ Hành
戎装世界=Nhung Trang Thế Giới
温副总=Ôn phó tổng
东升=Đông Thăng
高履=Cao Lữ
柳笙歌=Liễu Sênh Ca
嘉威=Gia Uy
李嘉威=Lý Gia Uy
童谣=Đồng Dao
李金海=Lý Kim Hải
关军彪=Quan Quân Bưu
关大狗=Quan Đại Cẩu
关俊彪=Quan Tuấn Bưu
涂大小姐=Đồ đại tiểu thư
小涂坤=Tiểu Đồ Khôn
涂坤=Đồ Khôn
第二00章=Chương 200:
白石=Bạch Thạch
钱婉=Tiền Uyển
涂骁=Đồ Kiêu
小北北=Tiểu Bắc Bắc
吴思琯=Ngô Tư Quản
钱玲=Tiền Linh
王楠=Vương Nam
林孟德=Lâm Mạnh Đức
钱董=Tiền đổng
季静=Quý Tịnh
李二=Lý Nhị
李多乐=Lý Đa Nhạc
火灶坊=Hỏa Táo Phường
第二0一章=Chương 201:
第二0二章=Chương 202:
陈萤=Trần Huỳnh
游千秋=Du Thiên Thu
丹霞宗=Đan Hà Tông
许媒婆=bà mối Hứa
王姝月=Vương Thù Nguyệt
姝月=Thù Nguyệt
小庆=Tiểu Khánh
丹霞城=Đan Hà Thành
孙鹏飞=Tôn Bằng Phi
赤灵体=Xích Linh Thể
马哲=Mã Triết
第二0三章=Chương 203:
李怂=Lý Túng
洛无生=Lạc Vô Sinh
洛郎=Lạc lang
小雨璃=Tiểu Vũ Ly
霜雪=Sương Tuyết
雨璃=Vũ Ly
第二0五章=Chương 205:
第二0六章=Chương 206:
盛父=Thịnh phụ
闻恒=Văn Hằng
白常春=Bạch Thường Xuân
第二0七章=Chương 207:
第二0八章=Chương 208:
祝莪=Chúc Nga
许常=Hứa Thường
宫老师=Cung lão sư
温雅=Ôn Nhã
宫玄清=Cung Huyền Thanh
凌霜雪=Lăng Sương Tuyết
罗石城=La Thạch Thành
罗石村=La Thạch Thôn
玉龙国=Ngọc Long Quốc
程翰=Trình Hàn
陆无痕=Lục Vô Ngấn
叶紫姻=Diệp Tử Nhân
苏睸=Tô Mý
卓慕兰=Trác Mộ Lan
崇仙门=Sùng Tiên Môn
许若馨=Hứa Nhược Hinh
赵若馨=Triệu Nhược Hinh
许小雁=Hứa Tiểu Nhạn
许小鹊=Hứa Tiểu Thước
玄凤幻芝=Huyền Phượng Huyễn Chi
黑莲境=Hắc Liên Cảnh
月牙儿=Nguyệt Nha Nhi
明月殊=Minh Nguyệt Thù
翡翠=Phỉ Thúy
云彩遥=Vân Thải Dao
白阑=Bạch Lan
竹梦=Trúc Mộng
师皓=Sư Hạo
赵海松=Triệu Hải Tùng
吴铮身=Ngô Tranh Thân
卢师傅=Lư sư phó
圣玹仙子=Thánh Xuân Tiên Tử
火魅女=Hỏa Mị Nữ
蛮廷=Man đình
吉祥如意=Cát Tường Như Ý
紫姻圣者=Tử Nhân Thánh Giả
大盛朝=Đại Thịnh Triều
大盛=Đại Thịnh
金昊=Kim Hạo
烈尊义=Liệt Tôn Nghĩa
瘟王=Ôn Vương
天瘟魔=Thiên Ôn Ma
金昊王=Kim Hạo Vương
瘟皇=Ôn Hoàng
欲散=Dục Tản
翰山城=Hàn Sơn Thành
第五天之奇药=Đệ Ngũ Thiên Chi Kỳ Dược
乐欲散=Nhạc Dục Tản
华夏族=Hoa Hạ Tộc
崇明门=Sùng Minh Môn
玄魅功=Huyền Mị Công
仙冰决=Tiên Băng Quyết
紫姻妹妹=Tử Nhân muội muội
霜雪丹=Sương Tuyết Đan
仙雳六式=Tiên Lịch Lục Thức
何旭东=Hà Húc Đông
王艺瑾=Vương Nghệ Cẩn
第二0九章=Chương 209:
第二一0章=Chương 210:
雨 璃=Vũ Ly
帝晔氏=Đế Diệp Thị
白露=Bạch Lộ
刘小艳=Lưu Tiểu Diễm
古槐=Cổ Hòe
歃血孤阳=Sáp Huyết Cô Dương
游宫=Du Cung
邓良=Đặng Lương
皓哥=Hạo ca
田夕=Điền Tịch
徒单雄才=Đồ Đơn Hùng Tài
兀颜魁=Ngột Nhan Khôi
丽桐县主=Lệ Đồng huyện chủ
乌苏雅女=Ô Tô Nhã Nữ
乌苏宝腾=Ô Tô Bảo Đằng
仇江平=Cừu Giang Bình
叶晴=Diệp Tình
罗伊=Roy
唐羽=Đường Vũ
杜月皎=Đỗ Nguyệt Kiểu
邱平生=Khưu Bình Sinh
诗寇=Thi Khấu
诗寇蒂=Thi Khấu Đế
闵的千户=Mẫn thiên hộ
秦连城=Tần Liên Thành
齐颖=Tề Dĩnh
陆雨璃=Lục Vũ Ly
卢彤=Lư Đồng
邱阁主=Khưu các chủ
墨修竹=Mặc Tu Trúc
第二三0章=Chương 230:
陆秀=Lục Tú
欢吉=Hoan Cát
牛壮=Ngưu Tráng
卫绮=Vệ Khởi
李雄=Lý Hùng
成林=Thành Lâm
万西峰=Vạn Tây Phong
林成武=Lâm Thành Võ
林倾颜=Lâm Khuynh Nhan
青首相=Thanh thủ tướng
青首=Thanh Thủ
涂夭夭=Đồ Yểu Yểu
夭夭=Yểu Yểu
洛贝林=Lobelin
柳冥=Liễu Minh
第二四0章=Chương 240:
温巨婴=Ôn Cự Anh
费莲安娜=Feliana
欧兰诺德=Orlando
安格丝=Angela
丰旗=Phong Kỳ
温半仙=Ôn bán tiên
温仙女=Ôn tiên nữ
三昧火=Tam Muội Hỏa
苗素问=Miêu Tố Vấn
司元国=Tư Nguyên Quốc
云遥=Vân Dao
程锟=Trình Côn
周七=Chu Thất
亚斯特=Aster
的米娅=Mia
低德=Lower
苏力=Tô Lực
温孰=Ôn Thục
血狮=Huyết Sư
宗海=Tông Hải
雅姬=Nhã Cơ
将奥古斯=Will August
萝茜=Rosie
少萝茜=Dorothy
熊月儿=Hùng Nguyệt Nhi
李玉贞=Lý Ngọc Trinh
烛国=Chúc Quốc
桃城=Đào Thành
余旭=Dư Húc
秦无殇=Tần Vô Thương
妖妃=Yêu Phi
第二七0章=Chương 270
风玄=Phong Huyền
圣心明镜法=Thánh Tâm Minh Kính Pháp
玄冰决=Huyền Băng Quyết
黄鑫=Hoàng Hâm
秦枭=Tần Kiêu
Paris=Paris
墨痕=Mặc Ngấn
白小妖=Bạch Tiểu Yêu
鞠景=Cúc Cảnh
东苍临=Đông Thương Lâm
献武哥=Hiến Võ Ca
东献武=Đông Hiến Võ
云虹仙子=Vân Hồng tiên tử
东衮=Đông Cổn
荒洲=Hoang Châu
东家主=Đông gia chủ
东屈鹏=Đông Khuất Bằng
慕绘仙=Mộ Hội tiên
东青石=Đông Thanh Thạch
东家=Đông gia
云虹=Vân Hồng
临儿=Lâm nhi
殷芸绮=Ân Vân Khởi
孔素娥=Khổng Tố Nga
万里定云伞=Vạn Lý Định Vân Tản
李济正=Lý Tế Chính
惠萍=Huệ Bình
沈世华=Thẩm Thế Hoa
边师妹=Biên sư muội
虎枪=Hổ Thương
第二八0章=Chương 280:
天速星=Thiên Tốc Tinh
鬼极宗=Quỷ Cực Tông
绘仙=Hội tiên
苗霞=Miêu Hà
杨是非=Dương Thị Phi
燕帝=Yến đế
燕凌霜=Yến Lăng Sương
霜姨=Sương di
张琴=Trương Cầm
何凌=Hà Lăng
戴玉婵=Đới Ngọc Thiền
林寒=Lâm Hàn
赵玉柯=Triệu Ngọc Kha
太阿剑=Thái A kiếm
吉明月=Cát Minh Nguyệt
余静=Dư Tịnh
孙邈=Tôn Mạc
陆然=Lục Nhiên
慕菀栀=Mộ Uyển Chi
宁婠=Ninh Loan
菀栀=Uyển Chi
宫太阳=Cung Thái Dương
火龙镖=Hỏa Long Tiêu
萨莉尔=Sally
吉宗主=Cát tông chủ
戴师妹=Đới sư muội
鞠道友=Cúc đạo hữu
月湾=Nguyệt Loan
贝琳德尔=Beilindel
颠龙倒凤功=Điên Long Đảo Phượng Công
阴阳长生诀=Âm Dương Trường Sinh Quyết
木乙生息法=Mộc Ất Sinh Tức Pháp
观云舒=Quan Vân Thư
玄思=Huyền Tư
羽生=Vũ Sinh
杜玉=Đỗ Ngọc
以观云舒的姿势=Quan Vân Thư tư thế
楚长东都=Sở Trường Đông Đô
五气经=Ngũ Khí Kinh
云倚楼=Vân Ỷ Lâu
寻仙山=Tầm Tiên sơn
无涯门=Vô Nhai Môn
莲子镇=Liên Tử trấn
公孙若=Công Tôn Nhược
霜月=Sương Nguyệt
叶霜月=Diệp Sương Nguyệt
无涯帮=Vô Nhai Bang
无涯观=Vô Nhai Quan
白师尊=Bạch sư tôn
杜瑛=Đỗ Anh
杜瑶=Đỗ Dao
杜叔子别传=Đỗ Thúc Tử Biệt Truyền
叶冷星=Diệp Lãnh Tinh
马金刀=Mã Kim Đao
擅踢=Thiện Thích
李清雅=Lý Thanh Nhã
楚长东=Sở Trường Đông
苏烟=Tô Yên
蝶=Die
奈杰尔·霍桑=Nigelle Hawthorne
姓霍桑=họ Hawthorne
黎贝尔=Riebel
锋刃魔女=Phong Nhận Ma Nữ
蜃境珠=Thận Cảnh Châu
向淮之=Hướng Hoài Chi
程明=Trình Minh
程黎=Trình Lê
程宏远=Trình Hồng Viễn
林静怡=Lâm Tịnh Di
柳百肯=Liễu Bách Khẳng
李盼=Lý Phán
柳子涵=Liễu Tử Hàm
七影=Thất Ảnh
火胤=Hỏa Dận
京都梦华录=Kinh Đô Mộng Hoa Lục
叶斌松=Diệp Bân Tùng
混沌莲子=Hỗn Độn Liên Tử
毕铁黎=Tất Thiết Lê
鬼车一族=Quỷ Xa nhất tộc
鬼嫣=Quỷ Yên
叶荷琼=Diệp Hà Quỳnh
守清=Thủ Thanh
孔守清=Khổng Thủ Thanh
潇湘雅苑=Tiêu Tương nhã uyển
极阴融灵诀=Cực Âm Dung Linh Quyết
曲绮蓉=Khúc Khởi Dung
洞真=Động Chân
陈孜艺=Trần Tư Nghệ
男道=Nam Đạo
马博厉=Mã Bác Lệ
爱奎姿玄有限公司=Công ty TNHH Ái Khuê Tư Huyền
富尔维亚=Fulvia
提夫林=Tiefling
神裔=Aasimar
欲魔=Succubus
魅魔=Incubus
矮人语=tiếng Dwarf
尤达=Yoda
提尔=Tyr
扎德=Zhader
信仰海神=Tín Ngưỡng Hải Thần
油腻术=thuật tạo dầu
巴洛维亚=Barovia
玛隆=Malone
西姆=Tây Mẫu
紫珠=Tử Châu
大钱儿=Đại Tiền Nhi
小景=Tiểu Cảnh
素娥=Tố Nga
竹影记=Trúc Ảnh Ký
苏烟然=Tô Yên Nhiên
赵怜=Triệu Liên
高阶魅魔=Incubus cấp cao
恐爪怪=Hook Horror
崔斯特=Drizzt Do'Urden
卓尔=Drow
二十章=Chương 20:
马维=Mave
艾瑞儿=Ariel
提亚马特=Tiamat
王扬=Vương Dương
第一干四百零四章=Chương 1404:
黄警官=Hoàng cảnh quan
青灵=Thanh Linh
苏曦=Tô Hi
曦姐=Hi tỷ
黄琦=Hoàng Kỳ
萧帘容=Tiêu Liêm Dung
杜垩登=Do'Urden
牛头人=Minotaur
灰矮人=Duergar/Gray Dwarf
许游=Hứa Du
阿曲=A Khúc
浮浪=Phù Lãng
丁九=Đinh Cửu
陈寅恪=Trần Dần Khác
第三00章=Chương 300:
敖构=Ngao Cấu
凌宇文=Lăng Vũ Văn
班瑞家=gia tộc Baenre
昆舍尔=Kunsher
贾拉索=Jarlaxle
班瑞=Baenre
黑坑角斗场=đấu trường Black Pit
太阳密识=Thái Dương mật thức
小产=Tiểu Sản
黑汉=Hắc Hán
永明=Vĩnh Minh
周顺=Chu Thuận
雷米娅=Lemmia
第三0一章=Chương 301:
第三0二章=Chương 302:
涂老大=Đồ lão đại
云琴=Vân Cầm
沈筱=Thẩm Tiêu
贝洛斯=Bellows
贝洛斯脸上=trên mặt Bellows
第三0三章=Chương 303:
第三0四章=Chương 304:
孔青黛=Khổng Thanh Đại
鞠少宫主=Cúc thiếu cung chủ
孔道友=Khổng đạo hữu
是魔索布莱城= là thành Menzoberranzan
乌勒弗酒是=rượu Wulefu
三十三章=Chương 33:
普林赛斯=Princess
第三0五章=Chương 305:
第三0六章=Chương 306:
穆横=Mục Hoành
昊兴=Hạo Hưng
华昊=Hoa Hạo
夜百合=Dạ Bách Hợp
姜一然=Khương Nhất Nhiên
编驹山=Biên Câu sơn
孔生安=Khổng Sinh An
望江执事=Vọng Giang chấp sự
青黛道友=Thanh Đại đạo hữu
孔望江=Khổng Vọng Giang
马脸男=Mã Kiểm Nam
天煌=Thiên Hoàng
第三0七章=Chương 307:
第三0八章=Chương 308:
大兴城=Đại Hưng thành
青黛=Thanh Đại
玉婵=Ngọc Thiền
戴道友=Đới đạo hữu
帕西法尔=Parsifal
第三0九章=Chương 309:
第三一0章=Chương 310:
初雪=Sơ Tuyết
花落=Hoa Lạc
戴小姐=Đới tiểu thư
洛斯兽=Rothé
薛俊=Tiết Tuấn
苗景=Miêu Cảnh
如梦=Như Mộng
林尚义=Lâm Thượng Nghĩa
戴仙子=Đới tiên tử
天上阙=Thiên Thượng Khuyết
玄姹神合心印=Huyền Xá Thần Hợp Tâm Ấn
玄姹心印=Huyền Xá Tâm Ấn
无涯功=Vô Nhai công
卡罗斯特=Carlos
陆丛云=Lục Tùng Vân
纳邦德尔=Nabonde
巴拉家族的=gia tộc Bala
纳邦德尔时柱=Nabondel (Cột thời gian Nabonde)
蜘蛛学院=học viện Nhện
魔索贝拉的住所=Menzoberranzan
邱源=Khưu Nguyên
诗大雅=Thi Đại Nhã
薛灵=Tiết Linh
王文书=Vương văn thư
建康=Kiến Khang
薛队主=Tiết đội chủ
扑克脸=Phốc Khắc Kiểm
双五儿=Song Ngũ Nhi
里司=Lý Tư
杜三爷=Đỗ Tam gia
杜叔宝=Đỗ Thúc Bảo
杜三=Đỗ Tam
刘昭=Lưu Chiêu
柳惔=Liễu Đàm
张里司=Trương Lý Tư
上佐=Thượng Tá
上纲=Thượng Cương
乐庞=Nhạc Bàng
西昌=Tây Xương
乐小胖=Nhạc Tiểu Bàn
慧绪师太=Tuệ Tự sư thái
豫章王=Dự Chương Vương
谢四娘子=Tạ Tứ nương tử
小胖=Tiểu Bàn
谢星涵=Tạ Tinh Hàm
淯阳=Dục Dương
小凝=Tiểu Ngưng
谢安=Tạ An
乐湛=Nhạc Trạm
郭林宗=Quách Lâm Tông
邢国=Hình quốc
蔡国=Thái quốc
帝丘=Đế Khưu
州来=Châu Lai
许国=Hứa quốc
庾于陵=Dữu Vu Lăng
星涵=Tinh Hàm
世伯=Thế bá
王馆学=Vương Quán Học
于陵=Vu Lăng
天衍宗=Thiên Diễn Tông
周柏洛=Chu Bách Lạc
郝宇=Hách Vũ
张阡=Trương Thiên
艾塔黎亚=Aitalia
埃贡恩=Egonnen
戈尔工=Gorgon
丝卡佩=Sicape
方鸻=Phương Hằng
Heng=Heng
hast042=Hast042
罗塔奥=Luotao
罗戴尔=Rodale
魁洛特=Quileute
黎明之星=Lê Minh Chi Tinh
塔伦=Talen
龙啸山脉=dãy núi Long Khiếu
卡普卡=Kapka
弗洛尔=Flor
序章=Chương 0:
魁洛德=Quileute
泰索夫龙蜥兽=thằn lằn rồng Tessov
弥雅=Di Nhã
彩虹同盟=liên minh Cầu Vồng
杰弗利特=Jefflit
KUN=KUN
红茶=Hồng Trà
戈尔工河南岸=bờ nam sông Gorgon
塔拉之刃=lưỡi dao Telaar
Serval=Serval
银林之矛的总会=tổng hội Ngọn giáo Ngân Lâm
银林之矛=Ngọn giáo Ngân Lâm
杰弗利特红衣队=đội Hồng Y Jefflit
拜恩之战=trận chiến Bayern
沧海孤舟=Thương Hải Cô Chu
A2区域=khu vực A2
乔里=Kiều Lý
杰弗利特的红衣队=đội Hồng Y Jefflit
夜空长风=cơn gió đêm
秦执=Tần Chấp
银之翳=Bóng Bạc
银林之冠=vương miện của Ngân Lâm
米莱拉=Milera
欧力=Ouli
老练如丝卡佩=lão luyện như Sicape
曼蛇=Man Xà
万里堂=Vạn Lý Đường
万里长老=Vạn Lý trường lão
袁震=Viên Chấn
谢千寻=Tạ Thiên Tầm
毕子定=Tất Tử Định
谎言女神=nữ thần Dối Trá
周平顺着=Chu Bình Thuận Trước
纳比森=Nabison
袁依=Viên Y
浩克=Hạo Khắc
第三二0章=Chương 320:
苏供奉=Tô cung phụng
谭广寿=Đàm Quảng Thọ
徐希羽=Từ Hi Vũ
吕沁瑶=Lữ Thấm Dao
海八院=viện Hải Bát
付红秀=Phó Hồng Tú
沁瑶=Thấm Dao
巩灵云=Củng Linh Vân
希羽=Hi Vũ
红秀=Hồng Tú
灵云=Linh Vân
余倩如=Dư Thiến Như
杨林秋=Dương Lâm Thu
刘晓=Lưu Hiểu
吴尔言=Ngô Nhĩ Ngôn
庄向林=Trang Hướng Lâm
乔双双=Kiều Song Song
吴诗怡=Ngô Thi Di
艾艾=Ngải Ngải
张艺远=Trương Nghệ Viễn
王虹卉=Vương Hồng Hủy
吕巩二人=Lữ Củng hai người
卉姐=Hủy tỷ
李捷高=Lý Tiệp Cao
苏怡琪=Tô Di Kỳ
付阿姨=Phó a di
卜兆杰=Bốc Triệu Kiệt
姜悦=Khương Duyệt
艺远=Nghệ Viễn
胡宁天=Hồ Ninh Thiên
柯欣莹=Kha Hân Oánh
木飞雪=Mộc Phi Tuyết
欧洋=Âu Dương
孟成=Mạnh Thành
诗怡=Thi Di
孟成明=Mạnh Thành Minh
刘晓真=Lưu Hiểu Chân
赵孟文=Triệu Mạnh Văn
华晴=Hoa Tình
悬泉客栈=khách sạn Huyền Tuyền
欣莹=Hân Oánh
凿空西域=Tạc Không Tây Vực
王张夫妇=Vương Trương vợ chồng
卜姜两人=Bốc Khương hai người
林阳=Lâm Dương
唞音=Douyin
卜老师=Bốc lão sư
悦姐=Duyệt tỷ
蓝云舒=Lam Vân Thư
徐庆山=Từ Khánh Sơn
平西军作战=quân tác chiến Bình Tây
周红羽=Chu Hồng Vũ
唐小怜=Đường Tiểu Liên
章怀德=Chương Hoài Đức
孟庆希=Mạnh Khánh Hi
燕裕=Yến Dụ
红羽姐=Hồng Vũ tỷ
刘龙韬=Lưu Long Thao
叶筠=Diệp Quân
陈灵韵=Trần Linh Vận
蓝龙王=Lam Long Vương
焦瀚=Tiêu Hãn
侣郝宇=Lữ Hách Vũ
韶华锁=Thiều Hoa Tỏa
郝夙蓓=Hách Túc Bội
夙蓓=Túc Bội
柏洛=Bách Lạc
玄龟息壳=Huyền Quy Tức Xác
黄执事=Hoàng chấp sự
四海阁=Tứ Hải các
妙华=Diệu Hoa
淮阴王=Hoài Âm Vương
晋世子=Tấn thế tử
洛长寿=Lạc Trường Thọ
刘约之=Lưu Ước Chi
穴钓=Cave Fisher
巨魔=Troll
之颜=Chi Nhan
古今丧服集记=Cổ Kim Tang Phục Tập Ký
义答问=Nghĩa Đáp Vấn
礼论要抄=Lễ Luận Yếu Sao
尚书·多方=Thượng Thư·Đa Phương
无逸篇=Vô Dật Thiên
指瑕=Chỉ Hà
童逻主=Đồng la chủ
连丝卡佩小姐=tiểu thư Sicape
江美女=Giang mỹ nữ
黎方圆=Lê Phương Viên
江子奇=Giang Tử Kỳ
李照江=Lý Chiếu Giang
江海=Giang Hải
玉玄衣=Ngọc Huyền Y
克里玛莎=Krimasha
黄文琴=Hoàng Văn Cầm
东道友=Đông đạo hữu
黄家权=Hoàng Gia Quyền
在天衍宗=ở Thiên Diễn tông
翠微剑=Thúy Vi Kiếm
田云升=Điền Vân Thăng
阴阳两仪微尘剑=Âm Dương Lưỡng Nghi Vi Trần Kiếm
曹继文=Tào Kế Văn
岁寒三老=Tuế Hàn Tam Lão
曲沐霞=Khúc Mộc Hà
许淑范=Hứa Thục Phạm
青云楼=Thanh Vân Lâu
苍临=Thương Lâm
王霸拳=Vương Bá Quyền
孔姓师妹=Khổng Tính sư muội
槐相桂=Hòe Tương Quế
徐如松=Từ Như Tùng
晨曦=Thần Hi
万里哥=Vạn Lý ca
周小友=Chu tiểu hữu
杨尘川=Dương Trần Xuyên
蜘蛛女神=nữ thần Nhện
刘廷=Lưu Đình
冷星=Lãnh Tinh
大离=Đại Ly
连雪=Liên Tuyết
荆锦=Kinh Cẩm
海林之冠=vương miện Hải Lâm
秦卫武=Tần Vệ Võ
歆然=Hâm Nhiên
魏峰=Ngụy Phong
井阳=Tỉnh Dương
铁断刚=Thiết Đoạn Cương
艾梅雅=Amelia
博克=Bock
海恩=Hein
帆姆=Fahm
考林=Kaulin
伊休=Isho
银之塔=tháp Bạc
塔塔=Tháp Tháp
乌洛波洛斯之环=vòng tròn Uroboros
特拉维尔=Traville
苏瓦条约=hiệp ước Suva
罗昊=La Hạo
黄炳坤=Hoàng Bính Khôn
赤港潮=Xích Cảng Triều
松山城=Tùng Sơn Thành
严阳=Nghiêm Dương
遛陵贰=Lưu Lăng Nhị
吴痕=Ngô Ngấn
王锐=Vương Nhuệ
涂山兰=Đồ Sơn Lan
无常爷=Vô Thường Gia
玉蝉=Ngọc Thiền
苍花娘娘=Thương Hoa nương nương
苏总捕=Tô Tổng Bổ
欢喜极乐功=Hoan Hỉ Cực Nhạc Công
维尔娜=Virna
深水城=Waterdeep
庾黔娄=Dữu Kiềm Lâu
艾奎因=Equinim
戈兰德=Goland
苏云锦=Tô Vân Cẩm
红鹰号=Hồng Ưng Hào
方世莲=Phương Thế Liên
戴安=Đới An
伊斯塔亚=Istria
格丽塔=Greta
都铎=Tudor
安勋爵=An huân tước
斯图亚=Stuart
萨瑞拉=Sarella
信风教会=giáo hội Tín Phong
贵安=Quý An
佩菲=Peffy
洛蒂娜=Lotina
姜临=Khương Lâm
狂兽=Cuồng Thú
姜玄应=Khương Huyền Ứng
王善=Vương Thiện
望阙=Vọng Khuyết
莱阳=Lai Dương
云彬=Vân Bân
徐家汇=Từ Gia Hối
袁晴=Viên Tình
袁声大=Viên Thanh Đại
顾茜=Cố Thiến
李点=Lý Điểm
恬静=Điềm Tịnh
恬总=Điềm tổng
声哥=Thanh Ca
声大哥=Thanh đại ca
静静=Tịnh Tịnh
徐沫=Từ Mạt
云麓=Vân Lộc
千樱=Thiên Anh
魏姐=Ngụy Thư
余烈=Dư Liệt
高云建=Cao Vân Kiến
吴青善=Ngô Thanh Thiện
杜西=Đỗ Tây
幽君七玄经=U Quân Thất Huyền Kinh
余谷楠=Dư Cốc Nam
余晓烟=Dư Hiểu Yên
小小=Tiểu Tiểu
玉女宗=Ngọc Nữ Tông
林落尘=Lâm Lạc Trần
林昌盛=Lâm Xương Thịnh
顾轻寒=Cố Khinh Hàn
冷月霜=Lãnh Nguyệt Sương
宿命轮回诀=Túc Mệnh Luân Hồi Quyết
断月妖峡=Đoạn Nguyệt Yêu Hạp
罗夭夭=La Yểu Yểu
万蝠山=Vạn Bức Sơn
阴阳合欢赋=Âm Dương Hợp Hoan Phú
曲泠音=Khúc Linh Âm
太虚神合经=Thái Hư Thần Hợp Kinh
宋弦筠=Tống Huyền Quân
周宫主=Chu cung chủ
秋芷师妹=Thu Chỉ sư muội
文宇=Văn Vũ
慕容秋芷=Mộ Dung Thu Chỉ
飞星=Phi Tinh
醉花坊=Túy Hoa Phường
秋芷=Thu Chỉ
罗耀=La Diệu
慕容夏竹=Mộ Dung Hạ Trúc
青石城=Thanh Thạch Thành
慕容南川=Mộ Dung Nam Xuyên
烈风斩=Liệt Phong Trảm
卫文轩=Vệ Văn Hiên
卫文宇=Vệ Văn Vũ
文轩=Văn Hiên
许清=Hứa Thanh
浩然正气诀=Hạo Nhiên Chính Khí Quyết
林! 落! 尘=Lâm! Lạc! Trần
我姓冷=ta học Lãnh
徐震虎=Từ Chấn Hổ
徐震=Từ Chấn
慕容康=Mộ Dung Khang
慕容西辰=Mộ Dung Tây Thần
南川=Nam Xuyên
落尘=Lạc Trần
第三三0章=Chương 330:
梁延嗣=Lương Diên Tự
梁宁汐=Lương Ninh Tịch
慕容寒=Mộ Dung Hàn
岚嫣=Lam Yên
长霆家=Trường Đình gia
李梨=Lý Lê
梨梨=Lê Lê
江湖豪雄榜=Giang Hồ Hào Hùng Bảng
沈皇后=Thẩm hoàng hậu
札克纳梵=Zaknafein
马烈丝=Maris
赫奈特=Hartnett
奥述=Osho
艾尔帕欣=Erpahine
艾缇拉=Atilla
唐儒=Đường Nho
魏不饱=Ngụy Bất Bão
柳河东=Liễu Hà Đông
小夭=Tiểu Yểu
布里莎=Brissa
天蓝=Thiên Lam
茉莉娅=Jasmine
四时二十四令生息法=Tứ Thời Nhị Thập Tứ Lệnh Sinh Tức Pháp
断情绝义剑=Đoạn Tình Tuyệt Nghĩa Kiếm
太上真玄功=Thái Thượng Chân Huyền Công
紫辰功=Tử Thần Công
AMEAME=AMEAME
AME=AME
宗测=Tông Trắc
塔波利斯=Tapolis
Secret=Secret
姬塔=Cơ Tháp
月秋=Nguyệt Thu
清月秋=Thanh Nguyệt Thu
欧阳落雪=Âu Dương Lạc Tuyết
关山道=Quan Sơn Đạo
向远=Hướng Viễn
剑山庄=Kiếm sơn trang
卷王=Quyển Vương
柳景生=Liễu Cảnh Sinh
苏砚=Tô Nghiễn
言叔=Ngôn thúc
司禾=Tư Hòa
大梁=Đại Lương
无涯剑=Vô Nhai Kiếm
无恨刀=Vô Hận Đao
马扎克=Mazak
沙耶克=Shaykh
妙妍=Diệu Nghiên
莲月=Liên Nguyệt
大化血煞神镖=Đại Hóa Huyết Sát Thần Tiêu
嘲风魔君=Trào Phong Ma Quân
嘲风=Trào Phong
心正=Tâm Chính
陈若风=Trần Nhược Phong
李明义=Lý Minh Nghĩa
铃音=Linh Âm
玲钰=Linh Ngọc
苏封侯=Tô phong hầu
周青峰=Chu Thanh Phong
在米国=ở nước Mỹ
白滩=White Beach
康格斯先生=ngài Kongos
白滩镇=thị trấn White Beach
康格斯=Kongos
威力球=Powerball
戴德县=quận Dada
斯瓦奇=Swatch
托托=Toto
托奇=Torchy
野马' 警车=Mustang xe cảnh sát
马修=Matthew
先锋控股=tập đoàn Pioneer
湖区橡树路=đường Lake Oak
老贝克=lão Baker
JP摩根=JP Morgan
灰鲨=Cá Mập Xám
舒尔特=Schulte
卡尔文森=Carl Vinson
埃尔文·怀特=Ivern White
汉默先生=ngài Hammer
FBI的卡尔=FBI Carl
赫尔伯特=Hurlburt
佛州=Florida
迪亚斯=Diaz
这大美利坚=nước Mỹ vĩ đại này
佛州州长=trưởng bang Florida
卡尔·文森=Carl Wenson
Zhou Qing Feng=Zhou Qing Feng
海伦. 格兰特=Helen Grant
卡尔. 文森=Carl Wenson 
卢克索=Luxor
卢拉=Lula
第三四0章=Chương 340:
揽仙镇=Lãm Tiên Trấn
德朗=Đức Lãng
胡迪=Hồ Địch
夏亚=Char
阿兹纳布尔=Aznable
乌蒂=Utti
小寒=Tiểu Hàn
商妙妍=Thương Diệu Nghiên
空林和尚=Không Lâm hòa thượng
凝血断魂烟=Ngưng Huyết Đoạn Hồn Yên
慕天生=Mộ Thiên Sinh
胡地=Hồ Địa
宁风=Ninh Phong
顾宁风=Cố Ninh Phong
卡斯尔敦=Castletown
布宜诺斯=Buenos
贝琳达=Belinda/Bối Lâm Đạt
达内河=sông Darnay
吉莉安=Gillian
烟云仙子=Yên Vân tiên tử
白夜仙子=Bạch Dạ tiên tử
留宴=Lưu Yến
焦正=Tiêu Chính
萧四十=Tiêu Tứ Thập
许继先=Hứa Kế Tiên
盼明珠=Phán Minh Châu
龙蹻经=Long Kiểu Kinh
极战诀=Cực Chiến Quyết
基韦斯特=Key West
的卡斯尔敦港=cảng Castletown
李荣浩=Lý Vinh Hạo
虎煞门=Hổ Sát Môn
格雷克=Gregg
格雷克·萨尔=Gregg Thrall
特拉维夫=Tel Aviv/Đặc Lạp Duy Phu
海明威=Hemingway
耐迪族=Nadyr tộc
坎帕斯=Campas
安琪尔=Angel
善心宝=Thiện Tâm Bảo
钰瑜=Ngọc Du
璃鸳=Ly Uyên
阿寒=A Hàn
叶璃鸳=Diệp Ly Uyên
凝樱=Ngưng Anh
混元八景真经=Hỗn Nguyên Bát Cảnh Chân Kinh
太上说玄天大圣真武本传神咒妙经=Thái Thượng Thuyết Huyền Thiên Đại Thánh Chân Võ Bản Truyền Thần Chú Diệu Kinh
庞枢=Bàng Khu
西米里安=Simeon
波塞顿=Poseidon
西米里安·波塞顿=Simeon Poseidon
加布林=Gabriel
班尼路=Benelux
菲高=Phỉ Cao
安度兰=Anduran
果果=Quả Quả
库克锐=Kukri
海伦·列娜=Helen Liena
姒姨=Tự di
耐瑟瑞尔=Netheril
玛索吉=Masoj
玛索吉·赫奈特=Masoj Hun'ett
于钰瑜=Vu Ngọc Du
图腾圣宗=Đồ Đằng Thánh Tông
商圣女=Thương Thánh Nữ
樊雅=Phàn Nhã
李杜=Lý Đỗ
玉林书院=thư viện Ngọc Lâm
真武妙经=Chân Võ Diệu Kinh
上清神霄真雷秘录=Thượng Thanh Thần Tiêu Chân Lôi Bí Lục
太清风露经=Thái Thanh Phong Lộ Kinh
太阴月华灵素经=Thái Âm Nguyệt Hoa Linh Tố Kinh
三千归一剑道=Tam Thiên Quy Nhất Kiếm Đạo
三皇金录=Tam Hoàng Kim Lục
九转丹道=Cửu Chuyển Đan Đạo
玉房秘诀=Ngọc Phòng Bí Quyết
素女道秘经=Tố Nữ Đạo Bí Kinh
无面大师=Vô Diện Đại Sư
关海法=Guenhwyvar
阳帝心经=Dương Đế Tâm Kinh
九曜=Cửu Diệu
逗比=Đậu Tỉ
合籍双修=Hợp Tịch Song Tu
张清溪=Trương Thanh Khê
孙燕晚=Tôn Yến Vãn
大琅皇帝=Đại Lang Hoàng Đế
黑光翰=Hắc Quang Hàn
天武移山诀=Thiên Võ Di Sơn Quyết
移岳珠=Di Nhạc Châu
嵩阳派=Tung Dương Phái
曲姑娘=Khúc cô nương
曲小姐=Khúc tiểu thư
蜘蛛法师=Spider Mage
安定尼=Andini
普利斯米尔=Prismeer
时之神殿=Thời Chi Thần Điện
邹泽禹=Trâu Trạch Vũ
张天谬=Trương Thiên Mậu
维斯兰=Vislaan
吴迪=Ngô Địch
茹科夫斯基=Zhukovsky
弗拉基米尔·尤里耶维奇·茹科夫斯基=Vladimir Yuryevich Zhukovsky
林柠=Lâm Ninh
陆若曦=Lục Nhược Hi
红织=Hồng Chức
庄梅=Trang Mai
青翎=Thanh Linh
翰景=Hàn Cảnh
王右军=Vương Hữu Quân
希尔薇德=Sylvia
丝碧卡=Spica
西林=Westwood
梁香月=Lương Hương Nguyệt
月还江=Nguyệt Hoàn Giang
上清龙蹻经=Thượng Thanh Long Kiểu Kinh
赵燕儿=Triệu Yến Nhi
张灵=Trương Linh
席娜菲=Sinafi
紫皇蝶=Tử Hoàng Điệp
第三六0章=Chương 360:
布丽姬忒=Bridget
青漪=Thanh Y
青藤=Thanh Đằng
十万云峰=Thập Vạn Vân Phong
丁恒=Đinh Hằng
阴阳灵灾 ]=Âm Dương Linh Tai ]
苏婼=Tô Nhược
阴劫体=Âm Kiếp Thể
阳劫体=Dương Kiếp Thể
灵灾=Linh Tai
仙祸=Tiên Họa
风月庵=Phong Nguyệt Am
婉约仙子=Uyển Ước tiên tử
劫体=Kiếp Thể
风月心经=Phong Nguyệt Tâm Kinh
无毒无垢三鬼魔功=Vô Độc Vô Cấu Tam Quỷ Ma Công
痴人绝=Si Nhân Tuyệt
千屠雪=Thiên Đồ Tuyết
太清净心诀=Thái Thanh Tịnh Tâm Quyết
太清玄经=Thái Thanh Huyền Kinh
阴阳劫体=Âm Dương Kiếp Thể
入炁=Nhập Khí
玄海=Huyền Hải
渡灵=Độ Linh
李明潇=Lý Minh Tiêu
琉璃手=Lưu Ly Thủ
明潇=Minh Tiêu
云官=Vân quan
紫玉女君=Tử Ngọc Nữ Quân
煞尊=Sát Tôn
清道=Thanh Đạo
禅道=Thiền Đạo
元曦明尊=Nguyên Hi Minh Tôn
禅道王尊=Thiền Đạo vương tôn
钟正阳=Chung Chính Dương
红莲天火=Hồng Liên Thiên Hỏa
元曦=Nguyên Hi
紫菩萨=Tử Bồ Tát
杨云君=Dương Vân Quân
云君=Vân Quân
神溪=Thần Khê
避瑕古剑=Tị Hà Cổ Kiếm
避瑕=Tị Hà
庵门=Am Môn
应天麟=Ứng Thiên Lân
天欢姹女=Thiên Hoan Xá Nữ
太微玉女道=Thái Vi Ngọc Nữ Đạo
九转明王菉=Cửu Chuyển Minh Vương Lục
岑见妙=Sầm Kiến Diệu
玄胤=Huyền Dận
白婉秋=Bạch Uyển Thu
天齐之国=Thiên Tề Chi Quốc
伯贤=Bá Hiền
洛纤凝=Lạc Tiêm Ngưng
刘孟星=Lưu Mạnh Tinh
风祖师=Phong tổ sư
关仁=Quan Nhân
顾幼梨=Cố Ấu Lê
洛小北=Lạc Tiểu Bắc
苏萍=Tô Bình
颜欢=Nhan Hoan
周宾=Chu Tân
柏忆=Bách Ức
八桥木=Bát Kiều Mộc
尤安丽娜=Vưu An Lệ Na
叶女士=Diệp nữ sĩ
赫密斯=Hermes
叶澜=Diệp Lan
叶诗语=Diệp Thi Ngữ
诗语=Thi Ngữ
樱宫=Anh Cung
艾希莉=Ashley
观身门=Quan Thân Môn
隐蛾=Ẩn Nga
周度=Chu Độ
栖原市=Tê Nguyên Thị
高雪娥=Cao Tuyết Nga
何考=Hà Khảo
螣信集团=tập đoàn Đằng Tín
云生活项目组=nhóm dự án Cloud Life
黄小胖=Hoàng Tiểu Bàn
娥总=Nga tổng
黄泗=Hoàng Tứ
松月楼=Tùng Nguyệt Lâu
钱固然=Tiền Cố Nhiên
芝麻公寓=nhà trọ Hạt Vừng
这个钱固然=Tiền Cố Nhiên này
方奇志=Phương Kỳ Chí
周艳=Chu Diễm
何常山=Hà Thường Sơn
